order_id,timeslice,0.0,200.0,401.0,polling_events,ECONNABORTED,GENERIC_ERROR
102452116,3m_after,0,1,0,1,0,0
102452116,3m_before,1,3,0,4,1,0
102452116,60m_before,1,31,0,32,1,0
102452190,3m_after,0,2,0,2,0,0
102452190,3m_before,1,3,0,4,1,0
102452190,60m_before,1,31,0,32,1,0
102453036,3m_after,0,7,0,7,0,0
102453036,3m_before,0,5,0,5,0,0
102453036,60m_before,1,36,0,37,1,0
102453649,3m_after,0,8,0,8,0,0
102453649,3m_before,0,8,0,8,0,0
102453649,60m_before,1,45,0,46,1,0
102453774,3m_after,0,10,0,10,0,0
102453774,3m_before,0,8,0,8,0,0
102453774,60m_before,1,47,0,48,1,0
102454140,3m_after,0,11,0,11,0,0
102454140,3m_before,0,9,0,9,0,0
102454140,60m_before,1,54,0,55,1,0
102456632,3m_after,3,25,0,28,3,0
102456632,3m_before,0,26,0,26,0,0
102456632,60m_before,1,175,0,176,1,0
102458251,3m_after,0,18,0,18,0,0
102458251,3m_before,0,19,0,19,0,0
102458251,60m_before,4,244,0,248,4,0
102458819,3m_after,0,19,0,19,0,0
102458819,3m_before,0,16,0,16,0,0
102458819,60m_before,4,266,0,270,4,0
102463944,3m_after,0,11,0,11,0,0
102463944,3m_before,0,10,0,10,0,0
102463944,60m_before,4,272,0,276,4,0
102472308,3m_after,2,1,0,3,2,0
102472308,3m_before,1,4,0,5,1,0
102472308,60m_before,5,123,0,128,4,1
102472764,3m_after,0,12,0,12,0,0
102472764,3m_before,0,2,0,2,0,0
102472764,60m_before,6,107,0,113,6,0
102478030,3m_after,0,12,0,12,0,0
102478030,3m_before,0,12,0,12,0,0
102478030,60m_before,0,139,0,139,0,0
102480758,3m_after,0,12,0,12,0,0
102480758,3m_before,0,11,0,11,0,0
102480758,60m_before,0,232,0,232,0,0
102480819,3m_after,0,11,0,11,0,0
102480819,3m_before,0,12,0,12,0,0
102480819,60m_before,0,233,0,233,0,0
102481086,3m_after,0,12,0,12,0,0
102481086,3m_before,0,11,0,11,0,0
102481086,60m_before,0,232,0,232,0,0
102481121,3m_after,0,11,0,11,0,0
102481121,3m_before,0,12,0,12,0,0
102481121,60m_before,0,232,0,232,0,0
102481959,3m_after,0,12,0,12,0,0
102481959,3m_before,0,11,0,11,0,0
102481959,60m_before,0,49,0,49,0,0
102482173,3m_after,0,11,0,11,0,0
102482173,3m_before,0,11,0,11,0,0
102482173,60m_before,0,231,0,231,0,0
102482468,3m_after,1,0,0,1,1,0
102482468,60m_before,0,6,0,6,0,0
102483020,3m_after,0,12,0,12,0,0
102483020,3m_before,0,12,0,12,0,0
102483020,60m_before,0,189,0,189,0,0
102483198,3m_after,0,12,0,12,0,0
102483198,3m_before,0,11,0,11,0,0
102483198,60m_before,0,189,0,189,0,0
102483764,3m_after,0,12,0,12,0,0
102483764,3m_before,0,12,0,12,0,0
102483764,60m_before,0,141,0,141,0,0
102484964,3m_before,0,11,0,11,0,0
102484964,60m_before,0,189,0,189,0,0
102486059,3m_after,0,10,0,10,0,0
102486059,3m_before,0,10,0,10,0,0
102486059,60m_before,0,170,0,170,0,0
102489610,3m_after,0,1,0,1,0,0
102489610,3m_before,0,12,0,12,0,0
102489610,60m_before,0,232,0,232,0,0
102490190,3m_after,0,11,0,11,0,0
102490190,3m_before,0,11,0,11,0,0
102490190,60m_before,0,34,0,34,0,0
102490403,3m_after,0,11,0,11,0,0
102490403,3m_before,0,11,0,11,0,0
102490403,60m_before,0,104,0,104,0,0
102490810,3m_after,0,9,0,9,0,0
102491029,3m_after,0,11,0,11,0,0
102491029,3m_before,0,12,0,12,0,0
102491029,60m_before,2,222,0,224,2,0
102491096,3m_after,0,12,0,12,0,0
102491096,3m_before,0,11,0,11,0,0
102491096,60m_before,0,231,0,231,0,0
102491906,60m_before,0,4,0,4,0,0
102492637,3m_after,0,12,0,12,0,0
102492637,3m_before,0,11,0,11,0,0
102492637,60m_before,1,227,0,228,1,0
102492671,3m_after,0,5,0,5,0,0
102492671,60m_before,0,14,0,14,0,0
102493319,3m_after,0,11,0,11,0,0
102493319,3m_before,0,12,0,12,0,0
102493319,60m_before,0,225,0,225,0,0
102493386,3m_after,0,3,0,3,0,0
102493461,3m_after,0,9,0,9,0,0
102493461,3m_before,0,1,0,1,0,0
102493461,60m_before,0,10,0,10,0,0
102493606,3m_after,0,12,0,12,0,0
102493606,3m_before,0,1,0,1,0,0
102493606,60m_before,0,11,0,11,0,0
102493678,60m_before,0,18,0,18,0,0
102493778,3m_after,0,10,0,10,0,0
102493778,3m_before,0,3,0,3,0,0
102493778,60m_before,0,25,0,25,0,0
102493927,3m_after,0,12,0,12,0,0
102493927,3m_before,0,12,0,12,0,0
102493927,60m_before,0,138,0,138,0,0
102494026,60m_before,0,18,0,18,0,0
102494117,3m_after,0,1,0,1,0,0
102494117,3m_before,0,7,0,7,0,0
102494117,60m_before,0,10,0,10,0,0
102494695,3m_after,0,11,0,11,0,0
102494695,3m_before,0,12,0,12,0,0
102494695,60m_before,0,127,0,127,0,0
102494709,60m_before,0,18,0,18,0,0
102494792,3m_after,0,12,0,12,0,0
102494792,3m_before,0,6,0,6,0,0
102494792,60m_before,0,121,0,121,0,0
102495032,3m_after,0,12,0,12,0,0
102495032,3m_before,0,11,0,11,0,0
102495032,60m_before,0,147,0,147,0,0
102495068,60m_before,0,18,0,18,0,0
102495234,3m_after,0,11,0,11,0,0
102495234,3m_before,0,12,0,12,0,0
102495234,60m_before,2,77,0,79,2,0
102495273,3m_after,0,11,0,11,0,0
102495273,3m_before,0,10,0,10,0,0
102495273,60m_before,0,52,0,52,0,0
102495395,3m_after,0,12,0,12,0,0
102495395,3m_before,0,12,0,12,0,0
102495395,60m_before,0,236,0,236,0,0
102495405,3m_after,0,11,0,11,0,0
102495405,3m_before,0,9,0,9,0,0
102495405,60m_before,0,56,0,56,0,0
102495458,60m_before,0,18,0,18,0,0
102495503,3m_after,0,12,0,12,0,0
102495503,3m_before,0,11,0,11,0,0
102495503,60m_before,0,144,0,144,0,0
102495625,3m_after,0,12,0,12,0,0
102495625,3m_before,0,11,0,11,0,0
102495625,60m_before,0,60,0,60,0,0
102495626,3m_after,0,12,0,12,0,0
102495626,3m_before,0,11,0,11,0,0
102495626,60m_before,0,146,0,146,0,0
102495645,3m_after,0,12,0,12,0,0
102495645,3m_before,0,11,0,11,0,0
102495645,60m_before,0,176,0,176,0,0
102495787,3m_after,0,2,0,2,0,0
102495787,60m_before,0,27,0,27,0,0
102495832,3m_after,0,11,0,11,0,0
102495832,3m_before,0,12,0,12,0,0
102495832,60m_before,0,193,0,193,0,0
102495915,60m_before,0,18,0,18,0,0
102496079,3m_after,0,12,0,12,0,0
102496079,3m_before,0,11,0,11,0,0
102496079,60m_before,0,206,0,206,0,0
102496158,3m_after,0,11,0,11,0,0
102496158,3m_before,0,11,0,11,0,0
102496158,60m_before,0,140,0,140,0,0
102496299,3m_after,0,9,0,9,0,0
102496299,3m_before,0,11,0,11,0,0
102496299,60m_before,0,65,0,65,0,0
102496386,60m_before,0,2,0,2,0,0
102496389,3m_after,0,12,0,12,0,0
102496389,3m_before,0,12,0,12,0,0
102496389,60m_before,1,100,0,101,1,0
102496405,3m_after,1,1,0,2,1,0
102496405,3m_before,2,2,0,4,2,0
102496405,60m_before,5,89,0,94,5,0
102496455,3m_after,0,12,0,12,0,0
102496455,3m_before,0,12,0,12,0,0
102496455,60m_before,0,182,0,182,0,0
102496552,3m_after,0,11,0,11,0,0
102496552,3m_before,0,12,0,12,0,0
102496552,60m_before,0,86,0,86,0,0
102496593,3m_after,0,12,0,12,0,0
102496593,3m_before,0,11,0,11,0,0
102496593,60m_before,0,234,0,234,0,0
102496784,3m_after,0,11,0,11,0,0
102496784,3m_before,0,12,0,12,0,0
102496784,60m_before,0,207,0,207,0,0
102496795,3m_after,0,11,0,11,0,0
102496795,3m_before,0,9,0,9,0,0
102496795,60m_before,0,74,0,74,0,0
102496850,3m_after,0,3,0,3,0,0
102496886,3m_after,0,11,0,11,0,0
102496886,3m_before,0,12,0,12,0,0
102496886,60m_before,0,210,0,210,0,0
102496897,3m_after,0,12,0,12,0,0
102496897,3m_before,0,11,0,11,0,0
102496897,60m_before,0,200,0,200,0,0
102496909,3m_after,0,6,0,6,0,0
102496909,3m_before,0,9,0,9,0,0
102496909,60m_before,0,108,0,108,0,0
102496935,60m_before,0,14,0,14,0,0
102497143,3m_after,0,11,0,11,0,0
102497143,3m_before,0,12,0,12,0,0
102497143,60m_before,0,198,0,198,0,0
102497171,3m_after,0,7,0,7,0,0
102497198,3m_after,0,17,0,17,0,0
102497198,3m_before,0,11,0,11,0,0
102497198,60m_before,1,190,0,191,1,0
102497271,60m_before,0,18,0,18,0,0
102497303,3m_after,0,11,0,11,0,0
102497303,3m_before,0,11,0,11,0,0
102497303,60m_before,0,19,0,19,0,0
102497315,60m_before,0,18,0,18,0,0
102497378,3m_after,0,10,0,10,0,0
102497378,3m_before,0,11,0,11,0,0
102497378,60m_before,0,20,0,20,0,0
102497388,3m_after,0,10,0,10,0,0
102497388,3m_before,0,12,0,12,0,0
102497388,60m_before,0,21,0,21,0,0
102497548,3m_after,0,11,0,11,0,0
102497548,3m_before,0,11,0,11,0,0
102497548,60m_before,2,207,0,209,2,0
102497744,3m_after,0,1,0,1,0,0
102497772,3m_after,0,12,0,12,0,0
102497772,3m_before,0,10,0,10,0,0
102497772,60m_before,0,28,0,28,0,0
102497798,3m_after,0,12,0,12,0,0
102497798,3m_before,0,11,0,11,0,0
102497798,60m_before,0,106,0,106,0,0
102497874,3m_after,1,9,0,10,1,0
102497874,3m_before,0,10,0,10,0,0
102497874,60m_before,2,206,0,208,2,0
102498113,3m_after,0,12,0,12,0,0
102498113,3m_before,0,10,0,10,0,0
102498113,60m_before,0,233,0,233,0,0
102498116,3m_after,0,10,0,10,0,0
102498116,3m_before,0,12,0,12,0,0
102498116,60m_before,0,213,0,213,0,0
102498130,3m_after,0,12,0,12,0,0
102498130,3m_before,0,11,0,11,0,0
102498130,60m_before,0,234,0,234,0,0
102498152,3m_after,0,12,0,12,0,0
102498152,3m_before,0,11,0,11,0,0
102498152,60m_before,0,145,0,145,0,0
102498272,3m_after,0,11,0,11,0,0
102498272,3m_before,0,11,0,11,0,0
102498272,60m_before,1,194,0,195,0,1
102498316,3m_after,0,11,0,11,0,0
102498316,3m_before,0,12,0,12,0,0
102498316,60m_before,0,152,0,152,0,0
102498337,3m_after,0,12,0,12,0,0
102498337,3m_before,0,11,0,11,0,0
102498337,60m_before,0,224,0,224,0,0
102498412,3m_after,0,12,0,12,0,0
102498412,3m_before,0,12,0,12,0,0
102498412,60m_before,0,234,0,234,0,0
102498417,3m_after,0,2,0,2,0,0
102498526,3m_after,0,11,0,11,0,0
102498526,3m_before,0,12,0,12,0,0
102498526,60m_before,0,234,0,234,0,0
102498531,3m_after,0,12,0,12,0,0
102498531,3m_before,0,10,0,10,0,0
102498531,60m_before,1,58,0,59,1,0
102498573,3m_after,0,9,0,9,0,0
102498573,3m_before,0,10,0,10,0,0
102498573,60m_before,3,204,0,207,3,0
102498631,3m_after,0,12,0,12,0,0
102498631,3m_before,0,11,0,11,0,0
102498631,60m_before,0,25,0,25,0,0
102498633,3m_after,0,11,0,11,0,0
102498633,3m_before,0,12,0,12,0,0
102498633,60m_before,0,232,0,232,0,0
102498635,3m_after,0,12,0,12,0,0
102498635,3m_before,0,11,0,11,0,0
102498635,60m_before,0,130,0,130,0,0
102498704,3m_after,0,2,0,2,0,0
102498704,3m_before,0,2,0,2,0,0
102498704,60m_before,0,2,0,2,0,0
102498834,3m_after,0,11,0,11,0,0
102498834,3m_before,0,12,0,12,0,0
102498834,60m_before,1,212,0,213,1,0
102498984,3m_before,1,0,0,1,1,0
102498984,60m_before,1,141,0,142,1,0
102499025,3m_after,0,12,0,12,0,0
102499025,3m_before,0,11,0,11,0,0
102499025,60m_before,0,170,0,170,0,0
102499132,3m_after,0,4,0,4,0,0
102499132,3m_before,0,11,0,11,0,0
102499132,60m_before,0,116,0,116,0,0
102499356,60m_before,0,135,0,135,0,0
102499382,3m_after,0,4,0,4,0,0
102499382,3m_before,0,8,0,8,0,0
102499382,60m_before,0,8,0,8,0,0
102499398,60m_before,0,21,0,21,0,0
102499546,3m_after,0,12,0,12,0,0
102499546,3m_before,0,11,0,11,0,0
102499546,60m_before,0,230,0,230,0,0
102499561,3m_after,0,10,0,10,0,0
102499561,3m_before,0,11,0,11,0,0
102499561,60m_before,6,161,0,167,6,0
102499654,3m_after,0,10,0,10,0,0
102499654,3m_before,0,8,0,8,0,0
102499654,60m_before,1,224,0,225,1,0
102499690,3m_after,0,3,0,3,0,0
102499690,3m_before,0,1,0,1,0,0
102499690,60m_before,0,33,0,33,0,0
102499705,60m_before,0,12,0,12,0,0
102499712,3m_after,0,6,0,6,0,0
102499712,3m_before,0,3,0,3,0,0
102499712,60m_before,0,8,0,8,0,0
102499713,3m_after,0,7,0,7,0,0
102499713,60m_before,0,51,0,51,0,0
102499746,3m_after,0,11,0,11,0,0
102499746,3m_before,0,12,0,12,0,0
102499746,60m_before,0,68,0,68,0,0
102499775,3m_after,0,12,0,12,0,0
102499775,3m_before,0,11,0,11,0,0
102499775,60m_before,0,230,0,230,0,0
102499852,3m_after,0,12,0,12,0,0
102499852,3m_before,0,11,0,11,0,0
102499852,60m_before,0,229,0,229,0,0
102499878,3m_after,0,11,0,11,0,0
102499878,3m_before,0,12,0,12,0,0
102499878,60m_before,0,22,0,22,0,0
102499935,3m_after,0,3,0,3,0,0
102499935,3m_before,0,3,0,3,0,0
102499935,60m_before,0,11,0,11,0,0
102499966,3m_after,0,10,0,10,0,0
102499966,3m_before,1,7,0,8,1,0
102499966,60m_before,4,202,0,206,4,0
102499976,3m_after,0,11,0,11,0,0
102499976,3m_before,0,11,0,11,0,0
102499976,60m_before,0,230,0,230,0,0
102499994,3m_after,0,12,0,12,0,0
102499994,3m_before,0,3,0,3,0,0
102499994,60m_before,0,134,0,134,0,0
102500001,3m_after,0,12,0,12,0,0
102500001,3m_before,0,11,0,11,0,0
102500001,60m_before,0,165,0,165,0,0
102500069,3m_after,0,12,0,12,0,0
102500069,3m_before,0,11,0,11,0,0
102500069,60m_before,6,174,0,180,6,0
102500070,3m_after,0,6,0,6,0,0
102500070,3m_before,0,11,0,11,0,0
102500070,60m_before,1,210,0,211,1,0
102500116,3m_after,0,12,0,12,0,0
102500116,3m_before,0,11,0,11,0,0
102500116,60m_before,0,223,0,223,0,0
102500373,3m_after,0,11,0,11,0,0
102500373,3m_before,0,12,0,12,0,0
102500373,60m_before,0,234,0,234,0,0
102500374,60m_before,1,182,0,183,0,1
102500453,3m_after,0,11,0,11,0,0
102500453,3m_before,0,12,0,12,0,0
102500453,60m_before,0,137,0,137,0,0
102500565,3m_after,0,11,0,11,0,0
102500565,3m_before,0,12,0,12,0,0
102500565,60m_before,0,236,0,236,0,0
102500591,3m_after,0,12,0,12,0,0
102500591,3m_before,0,11,0,11,0,0
102500591,60m_before,0,233,0,233,0,0
102500685,3m_after,1,6,0,7,1,0
102500685,3m_before,1,1,0,2,1,0
102500685,60m_before,2,142,0,144,2,0
102500691,3m_after,0,11,0,11,0,0
102500691,3m_before,0,12,0,12,0,0
102500691,60m_before,0,232,0,232,0,0
102500723,60m_before,2,4,0,6,2,0
102500725,3m_after,0,12,0,12,0,0
102500725,3m_before,0,12,0,12,0,0
102500725,60m_before,0,236,0,236,0,0
102500749,3m_after,0,3,0,3,0,0
102500749,60m_before,0,14,0,14,0,0
102500765,3m_after,0,11,0,11,0,0
102500765,3m_before,0,10,0,10,0,0
102500765,60m_before,0,156,0,156,0,0
102500800,3m_after,0,3,0,3,0,0
102500800,3m_before,1,1,0,2,0,1
102500800,60m_before,1,28,0,29,0,1
102500844,3m_after,0,11,0,11,0,0
102500844,3m_before,0,11,0,11,0,0
102500844,60m_before,1,152,0,153,1,0
102500866,3m_after,0,12,0,12,0,0
102500866,3m_before,0,11,0,11,0,0
102500866,60m_before,0,222,0,222,0,0
102500894,3m_after,0,11,0,11,0,0
102500894,3m_before,0,11,0,11,0,0
102500894,60m_before,0,234,0,234,0,0
102500978,3m_after,0,9,0,9,0,0
102500978,3m_before,0,11,0,11,0,0
102500978,60m_before,4,201,0,205,4,0
102500991,3m_after,0,12,0,12,0,0
102500991,3m_before,0,12,0,12,0,0
102500991,60m_before,0,145,0,145,0,0
102500992,3m_after,0,11,0,11,0,0
102500992,3m_before,0,11,0,11,0,0
102500992,60m_before,0,203,0,203,0,0
102500996,3m_after,0,12,0,12,0,0
102500996,3m_before,0,11,0,11,0,0
102500996,60m_before,0,224,0,224,0,0
102501039,3m_after,0,7,0,7,0,0
102501039,3m_before,0,4,0,4,0,0
102501039,60m_before,0,35,0,35,0,0
102501063,3m_after,0,23,0,23,0,0
102501063,3m_before,0,23,0,23,0,0
102501063,60m_before,0,204,0,204,0,0
102501100,3m_after,0,12,0,12,0,0
102501100,3m_before,0,12,0,12,0,0
102501100,60m_before,0,231,0,231,0,0
102501126,3m_after,0,11,0,11,0,0
102501126,3m_before,0,12,0,12,0,0
102501126,60m_before,0,222,0,222,0,0
102501158,3m_after,0,11,0,11,0,0
102501158,3m_before,0,12,0,12,0,0
102501158,60m_before,0,223,0,223,0,0
102501160,3m_after,0,11,0,11,0,0
102501160,3m_before,0,12,0,12,0,0
102501160,60m_before,0,222,0,222,0,0
102501216,3m_before,0,4,0,4,0,0
102501216,60m_before,1,31,0,32,0,1
102501311,3m_after,0,11,0,11,0,0
102501311,3m_before,0,6,0,6,0,0
102501311,60m_before,1,75,0,76,1,0
102501313,3m_after,0,12,0,12,0,0
102501313,3m_before,0,11,0,11,0,0
102501313,60m_before,0,81,0,81,0,0
102501348,3m_after,0,11,0,11,0,0
102501348,3m_before,0,12,0,12,0,0
102501348,60m_before,1,222,0,223,1,0
102501404,3m_after,0,12,0,12,0,0
102501404,3m_before,0,11,0,11,0,0
102501404,60m_before,1,221,0,222,1,0
102501467,3m_after,0,11,0,11,0,0
102501467,3m_before,0,11,0,11,0,0
102501467,60m_before,0,224,0,224,0,0
102501559,3m_after,0,23,0,23,0,0
102501559,3m_before,0,23,0,23,0,0
102501559,60m_before,0,274,0,274,0,0
102501575,3m_after,0,12,0,12,0,0
102501575,3m_before,0,11,0,11,0,0
102501575,60m_before,0,229,0,229,0,0
102501597,3m_after,0,12,0,12,0,0
102501597,3m_before,0,11,0,11,0,0
102501597,60m_before,0,120,0,120,0,0
102501673,3m_after,0,11,0,11,0,0
102501673,3m_before,0,11,0,11,0,0
102501673,60m_before,1,222,0,223,1,0
102501694,3m_after,0,12,0,12,0,0
102501694,3m_before,0,8,0,8,0,0
102501694,60m_before,0,90,0,90,0,0
102501706,3m_after,0,11,0,11,0,0
102501706,3m_before,0,12,0,12,0,0
102501706,60m_before,0,134,0,134,0,0
102501771,60m_before,0,18,0,18,0,0
102501813,3m_after,0,11,0,11,0,0
102501813,3m_before,0,12,0,12,0,0
102501813,60m_before,0,234,0,234,0,0
102501818,3m_after,0,11,0,11,0,0
102501818,3m_before,0,12,0,12,0,0
102501818,60m_before,4,89,0,93,0,4
102501841,3m_after,0,12,0,12,0,0
102501841,3m_before,0,10,0,10,0,0
102501841,60m_before,0,229,0,229,0,0
102501909,3m_after,0,12,0,12,0,0
102501909,3m_before,0,11,0,11,0,0
102501909,60m_before,0,135,0,135,0,0
102501915,3m_after,0,7,0,7,0,0
102501915,3m_before,0,11,0,11,0,0
102501915,60m_before,9,150,0,159,9,0
102501918,3m_after,0,12,0,12,0,0
102501918,3m_before,0,8,0,8,0,0
102501918,60m_before,0,8,0,8,0,0
102501931,3m_after,0,11,0,11,0,0
102501931,3m_before,0,12,0,12,0,0
102501931,60m_before,0,97,0,97,0,0
102501936,3m_after,0,11,0,11,0,0
102501936,3m_before,0,11,0,11,0,0
102501936,60m_before,2,168,0,170,1,1
102501997,3m_after,0,12,0,12,0,0
102501997,3m_before,0,12,0,12,0,0
102501997,60m_before,0,231,0,231,0,0
102501999,3m_after,0,12,0,12,0,0
102501999,3m_before,0,11,0,11,0,0
102501999,60m_before,0,231,0,231,0,0
102502027,3m_after,0,11,0,11,0,0
102502027,3m_before,0,12,0,12,0,0
102502027,60m_before,0,130,0,130,0,0
102502030,60m_before,2,108,0,110,2,0
102502049,3m_after,0,12,0,12,0,0
102502049,3m_before,0,11,0,11,0,0
102502049,60m_before,0,232,0,232,0,0
102502074,3m_after,0,11,0,11,0,0
102502074,3m_before,0,12,0,12,0,0
102502074,60m_before,0,131,0,131,0,0
102502078,3m_after,0,11,0,11,0,0
102502078,3m_before,0,12,0,12,0,0
102502078,60m_before,0,235,0,235,0,0
102502119,60m_before,0,18,0,18,0,0
102502121,3m_after,0,11,0,11,0,0
102502121,3m_before,0,11,0,11,0,0
102502121,60m_before,0,133,0,133,0,0
102502140,3m_after,1,0,0,1,1,0
102502140,3m_before,0,1,0,1,0,0
102502140,60m_before,1,9,0,10,1,0
102502178,3m_after,0,11,0,11,0,0
102502178,3m_before,0,11,0,11,0,0
102502178,60m_before,1,105,0,106,1,0
102502183,3m_before,0,2,0,2,0,0
102502183,60m_before,1,163,0,164,0,1
102502301,60m_before,1,38,0,39,1,0
102502304,3m_after,2,1,0,3,2,0
102502304,3m_before,0,10,0,10,0,0
102502304,60m_before,2,194,0,196,2,0
102502367,3m_after,0,11,0,11,0,0
102502367,3m_before,0,12,0,12,0,0
102502367,60m_before,0,232,0,232,0,0
102502421,60m_before,0,18,0,18,0,0
102502443,3m_after,2,5,0,7,2,0
102502443,3m_before,0,9,0,9,0,0
102502443,60m_before,6,154,0,160,6,0
102502447,3m_after,0,12,0,12,0,0
102502447,3m_before,0,12,0,12,0,0
102502447,60m_before,0,232,0,232,0,0
102502467,3m_after,0,11,0,11,0,0
102502467,3m_before,0,12,0,12,0,0
102502467,60m_before,0,221,0,221,0,0
102502481,3m_after,0,1,0,1,0,0
102502481,60m_before,0,18,0,18,0,0
102502500,3m_after,0,10,0,10,0,0
102502500,3m_before,2,2,0,4,2,0
102502500,60m_before,2,73,0,75,2,0
102502664,3m_after,0,11,0,11,0,0
102502664,3m_before,1,9,0,10,1,0
102502664,60m_before,1,25,0,26,1,0
102502696,3m_after,0,1,0,1,0,0
102502696,60m_before,0,18,0,18,0,0
102502819,3m_after,1,5,0,6,1,0
102502819,3m_before,2,4,0,6,2,0
102502819,60m_before,8,148,0,156,8,0
102502873,3m_after,0,12,0,12,0,0
102502873,3m_before,0,11,0,11,0,0
102502873,60m_before,0,230,0,230,0,0
102502886,60m_before,1,114,0,115,1,0
102502980,3m_after,0,12,0,12,0,0
102502980,3m_before,0,12,0,12,0,0
102502980,60m_before,0,233,0,233,0,0
102502997,3m_before,0,1,0,1,0,0
102502997,60m_before,0,19,0,19,0,0
102503158,3m_after,1,7,0,8,1,0
102503158,3m_before,0,10,0,10,0,0
102503158,60m_before,8,154,0,162,8,0
102503165,3m_after,0,11,0,11,0,0
102503165,3m_before,0,12,0,12,0,0
102503165,60m_before,0,232,0,232,0,0
102503173,3m_after,0,8,0,8,0,0
102503173,3m_before,0,11,0,11,0,0
102503173,60m_before,0,231,0,231,0,0
102503214,3m_after,0,1,0,1,0,0
102503214,60m_before,0,18,0,18,0,0
102503221,3m_after,0,1,0,1,0,0
102503221,60m_before,0,18,0,18,0,0
102503319,3m_after,0,2,0,2,0,0
102503319,3m_before,0,11,0,11,0,0
102503319,60m_before,1,107,0,108,0,1
102503329,3m_after,0,12,0,12,0,0
102503329,3m_before,0,11,0,11,0,0
102503329,60m_before,0,199,0,199,0,0
102503347,60m_before,0,117,0,117,0,0
102503353,3m_after,0,6,0,6,0,0
102503353,3m_before,0,5,0,5,0,0
102503353,60m_before,1,43,0,44,1,0
102503362,3m_after,0,12,0,12,0,0
102503362,3m_before,0,11,0,11,0,0
102503362,60m_before,0,160,0,160,0,0
102503414,3m_after,0,11,0,11,0,0
102503414,3m_before,0,11,0,11,0,0
102503414,60m_before,4,196,0,200,4,0
102503493,3m_after,0,1,0,1,0,0
102503493,60m_before,0,19,0,19,0,0
102503496,3m_after,0,12,0,12,0,0
102503496,3m_before,0,12,0,12,0,0
102503496,60m_before,0,204,0,204,0,0
102503552,3m_after,0,12,0,12,0,0
102503552,3m_before,0,11,0,11,0,0
102503552,60m_before,0,164,0,164,0,0
102503566,3m_after,0,12,0,12,0,0
102503566,3m_before,0,11,0,11,0,0
102503566,60m_before,0,231,0,231,0,0
102503608,3m_after,0,1,0,1,0,0
102503608,60m_before,0,19,0,19,0,0
102503664,3m_after,0,11,0,11,0,0
102503664,3m_before,0,12,0,12,0,0
102503664,60m_before,0,231,0,231,0,0
102503690,3m_after,0,11,0,11,0,0
102503690,3m_before,0,12,0,12,0,0
102503690,60m_before,0,224,0,224,0,0
102503743,3m_after,0,12,0,12,0,0
102503743,3m_before,0,11,0,11,0,0
102503743,60m_before,0,231,0,231,0,0
102503774,3m_after,0,7,0,7,0,0
102503774,60m_before,0,19,0,19,0,0
102503775,3m_after,0,2,0,2,0,0
102503775,60m_before,0,19,0,19,0,0
102503836,3m_after,0,12,0,12,0,0
102503836,3m_before,0,9,0,9,0,0
102503836,60m_before,0,134,0,134,0,0
102503842,3m_after,0,11,0,11,0,0
102503842,3m_before,0,10,0,10,0,0
102503842,60m_before,4,195,0,199,4,0
102503873,3m_after,0,12,0,12,0,0
102503873,3m_before,0,11,0,11,0,0
102503873,60m_before,0,171,0,171,0,0
102503897,3m_after,0,12,0,12,0,0
102503897,3m_before,0,12,0,12,0,0
102503897,60m_before,0,235,0,235,0,0
102503909,3m_before,0,9,0,9,0,0
102503909,60m_before,1,48,0,49,1,0
102503921,3m_after,0,7,0,7,0,0
102503921,60m_before,0,19,0,19,0,0
102503965,60m_before,0,178,0,178,0,0
102504010,3m_after,1,8,0,9,1,0
102504010,3m_before,0,10,0,10,0,0
102504010,60m_before,0,215,0,215,0,0
102504026,3m_after,0,2,0,2,0,0
102504038,3m_after,0,10,0,10,0,0
102504038,3m_before,0,10,0,10,0,0
102504038,60m_before,1,210,0,211,1,0
102504056,3m_after,0,11,0,11,0,0
102504056,3m_before,0,11,0,11,0,0
102504056,60m_before,0,218,0,218,0,0
102504080,3m_after,0,11,0,11,0,0
102504080,3m_before,0,12,0,12,0,0
102504080,60m_before,0,236,0,236,0,0
102504140,3m_after,1,7,0,8,1,0
102504140,3m_before,0,12,0,12,0,0
102504140,60m_before,0,231,0,231,0,0
102504337,3m_after,0,1,0,1,0,0
102504337,60m_before,0,201,0,201,0,0
102504352,3m_after,0,3,0,3,0,0
102504352,60m_before,0,19,0,19,0,0
102504404,3m_after,0,11,0,11,0,0
102504404,3m_before,0,7,0,7,0,0
102504404,60m_before,0,7,0,7,0,0
102504478,3m_after,0,12,0,12,0,0
102504478,3m_before,0,12,0,12,0,0
102504478,60m_before,0,232,0,232,0,0
102504524,3m_after,0,11,0,11,0,0
102504524,3m_before,0,12,0,12,0,0
102504524,60m_before,0,235,0,235,0,0
102504564,3m_after,0,12,0,12,0,0
102504564,3m_before,0,11,0,11,0,0
102504564,60m_before,0,185,0,185,0,0
102504593,60m_before,0,104,0,104,0,0
102504628,3m_after,0,12,0,12,0,0
102504628,3m_before,0,11,0,11,0,0
102504628,60m_before,1,178,0,179,0,1
102504640,3m_after,1,7,0,8,1,0
102504640,3m_before,0,11,0,11,0,0
102504640,60m_before,0,230,0,230,0,0
102504655,3m_after,0,9,0,9,0,0
102504655,3m_before,0,10,0,10,0,0
102504655,60m_before,4,197,0,201,4,0
102504765,3m_after,0,11,0,11,0,0
102504765,3m_before,0,12,0,12,0,0
102504765,60m_before,0,235,0,235,0,0
102504803,3m_after,0,9,0,9,0,0
102504803,3m_before,0,10,0,10,0,0
102504803,60m_before,2,192,0,194,2,0
102504809,3m_after,0,11,0,11,0,0
102504809,3m_before,0,12,0,12,0,0
102504809,60m_before,0,232,0,232,0,0
102504811,3m_after,0,12,0,12,0,0
102504811,3m_before,0,12,0,12,0,0
102504811,60m_before,0,234,0,234,0,0
102504820,3m_after,0,11,0,11,0,0
102504820,3m_before,0,11,0,11,0,0
102504820,60m_before,0,217,0,217,0,0
102504830,3m_after,0,12,0,12,0,0
102504830,3m_before,0,11,0,11,0,0
102504830,60m_before,0,194,0,194,0,0
102504844,3m_after,0,11,0,11,0,0
102504844,3m_before,0,11,0,11,0,0
102504844,60m_before,0,191,0,191,0,0
102504954,3m_after,0,11,0,11,0,0
102504954,3m_before,0,12,0,12,0,0
102504954,60m_before,0,235,0,235,0,0
102504980,60m_before,0,26,0,26,0,0
102504984,3m_after,0,12,0,12,0,0
102504984,3m_before,0,11,0,11,0,0
102504984,60m_before,1,121,0,122,0,1
102505042,60m_before,0,26,0,26,0,0
102505046,3m_after,0,11,0,11,0,0
102505046,3m_before,0,12,0,12,0,0
102505046,60m_before,0,207,0,207,0,0
102505130,3m_after,0,11,0,11,0,0
102505130,3m_before,0,12,0,12,0,0
102505130,60m_before,0,230,0,230,0,0
102505143,60m_before,0,26,0,26,0,0
102505247,3m_after,0,11,0,11,0,0
102505247,3m_before,0,4,0,4,0,0
102505247,60m_before,0,4,0,4,0,0
102505287,3m_after,0,10,0,10,0,0
102505287,3m_before,0,12,0,12,0,0
102505287,60m_before,0,217,0,217,0,0
102505303,3m_after,0,11,0,11,0,0
102505303,3m_before,0,12,0,12,0,0
102505303,60m_before,0,235,0,235,0,0
102505332,3m_after,0,12,0,12,0,0
102505332,3m_before,0,12,0,12,0,0
102505332,60m_before,0,178,0,178,0,0
102505371,3m_after,0,11,0,11,0,0
102505371,3m_before,0,12,0,12,0,0
102505371,60m_before,0,230,0,230,0,0
102505439,3m_after,0,1,0,1,0,0
102505439,60m_before,3,20,0,23,2,1
102505452,3m_after,0,11,0,11,0,0
102505452,3m_before,0,11,0,11,0,0
102505452,60m_before,1,214,0,215,1,0
102505459,60m_before,0,26,0,26,0,0
102505464,3m_after,0,12,0,12,0,0
102505464,3m_before,0,11,0,11,0,0
102505464,60m_before,0,233,0,233,0,0
102505504,3m_after,0,2,0,2,0,0
102505504,60m_before,3,20,0,23,2,1
102505517,3m_after,0,11,0,11,0,0
102505517,3m_before,0,9,0,9,0,0
102505517,60m_before,0,218,0,218,0,0
102505546,60m_before,0,30,0,30,0,0
102505573,3m_after,0,11,0,11,0,0
102505573,3m_before,0,11,0,11,0,0
102505573,60m_before,0,219,0,219,0,0
102505592,60m_before,0,26,0,26,0,0
102505595,3m_after,0,11,0,11,0,0
102505595,3m_before,0,11,0,11,0,0
102505595,60m_before,0,224,0,224,0,0
102505701,3m_after,0,11,0,11,0,0
102505701,3m_before,0,11,0,11,0,0
102505701,60m_before,0,219,0,219,0,0
102505867,3m_after,0,10,0,10,0,0
102505867,3m_before,0,5,0,5,0,0
102505867,60m_before,0,5,0,5,0,0
102505890,3m_after,1,2,0,3,1,0
102505890,3m_before,0,3,0,3,0,0
102505890,60m_before,0,3,0,3,0,0
102505902,3m_after,0,12,0,12,0,0
102505902,3m_before,0,12,0,12,0,0
102505902,60m_before,0,145,0,145,0,0
102505960,3m_before,0,2,0,2,0,0
102505960,60m_before,1,23,0,24,0,1
102505966,3m_after,2,6,0,8,1,1
102505966,3m_before,0,10,0,10,0,0
102505966,60m_before,9,154,0,163,9,0
102506039,3m_after,0,11,0,11,0,0
102506039,3m_before,0,12,0,12,0,0
102506039,60m_before,0,31,0,31,0,0
102506067,3m_after,0,11,0,11,0,0
102506067,3m_before,0,11,0,11,0,0
102506067,60m_before,4,195,0,199,4,0
102506173,3m_after,0,12,0,12,0,0
102506173,3m_before,0,11,0,11,0,0
102506173,60m_before,1,193,0,194,0,1
102506269,3m_after,1,7,0,8,1,0
102506269,3m_before,0,9,0,9,0,0
102506269,60m_before,4,194,0,198,4,0
102506283,60m_before,0,26,0,26,0,0
102506286,3m_after,0,12,0,12,0,0
102506286,3m_before,0,11,0,11,0,0
102506286,60m_before,2,206,0,208,2,0
102506299,60m_before,0,89,0,89,0,0
102506472,3m_after,0,12,0,12,0,0
102506472,3m_before,0,11,0,11,0,0
102506472,60m_before,0,176,0,176,0,0
102506539,3m_after,0,10,0,10,0,0
102506539,3m_before,0,10,0,10,0,0
102506539,60m_before,9,166,0,175,8,1
102506569,3m_after,0,12,0,12,0,0
102506569,3m_before,0,11,0,11,0,0
102506569,60m_before,3,148,0,151,3,0
102506573,3m_after,0,2,0,2,0,0
102506573,3m_before,0,3,0,3,0,0
102506573,60m_before,1,3,0,4,1,0
102506589,60m_before,0,39,0,39,0,0
102506596,3m_after,0,12,0,12,0,0
102506596,3m_before,0,11,0,11,0,0
102506596,60m_before,1,228,0,229,1,0
102506707,60m_before,0,30,0,30,0,0
102506721,3m_after,0,12,0,12,0,0
102506721,3m_before,0,12,0,12,0,0
102506721,60m_before,0,178,0,178,0,0
102506726,3m_after,0,12,0,12,0,0
102506726,3m_before,0,11,0,11,0,0
102506726,60m_before,0,225,0,225,0,0
102506744,3m_after,0,7,0,7,0,0
102506744,3m_before,0,12,0,12,0,0
102506744,60m_before,0,224,0,224,0,0
102506751,60m_before,1,51,0,52,1,0
102506754,60m_before,1,110,0,111,1,0
102506797,3m_after,0,11,0,11,0,0
102506797,3m_before,0,10,0,10,0,0
102506797,60m_before,4,195,0,199,4,0
102506849,3m_after,0,10,0,10,0,0
102506849,3m_before,0,11,0,11,0,0
102506849,60m_before,0,220,0,220,0,0
102506952,3m_after,0,8,0,8,0,0
102506952,3m_before,0,6,0,6,0,0
102506952,60m_before,0,133,0,133,0,0
102506953,3m_after,0,11,0,11,0,0
102506953,3m_before,0,12,0,12,0,0
102506953,60m_before,0,232,0,232,0,0
102506967,3m_after,0,12,0,12,0,0
102506967,3m_before,0,11,0,11,0,0
102506967,60m_before,0,226,0,226,0,0
102507029,3m_after,0,12,0,12,0,0
102507029,3m_before,0,12,0,12,0,0
102507029,60m_before,1,210,0,211,0,1
102507077,3m_after,0,12,0,12,0,0
102507077,3m_before,0,9,0,9,0,0
102507077,60m_before,9,173,0,182,8,1
102507088,3m_after,0,12,0,12,0,0
102507088,3m_before,0,12,0,12,0,0
102507088,60m_before,0,38,0,38,0,0
102507102,3m_after,0,23,0,23,0,0
102507102,3m_before,0,22,0,22,0,0
102507102,60m_before,0,355,0,355,0,0
102507212,60m_before,0,128,0,128,0,0
102507223,3m_after,0,12,0,12,0,0
102507223,3m_before,0,12,0,12,0,0
102507223,60m_before,1,229,0,230,1,0
102507298,60m_before,0,26,0,26,0,0
102507368,60m_before,0,26,0,26,0,0
102507411,3m_after,0,12,0,12,0,0
102507411,3m_before,0,11,0,11,0,0
102507411,60m_before,3,163,0,166,3,0
102507541,3m_after,0,12,0,12,0,0
102507541,3m_before,0,10,0,10,0,0
102507541,60m_before,0,231,0,231,0,0
102507566,3m_before,0,1,0,1,0,0
102507566,60m_before,0,7,0,7,0,0
102507578,60m_before,0,26,0,26,0,0
102507638,60m_before,0,26,0,26,0,0
102507696,3m_after,0,11,0,11,0,0
102507696,3m_before,0,11,0,11,0,0
102507696,60m_before,0,218,0,218,0,0
102507771,3m_after,0,12,0,12,0,0
102507771,3m_before,0,10,0,10,0,0
102507771,60m_before,5,191,0,196,5,0
102507811,3m_after,0,11,0,11,0,0
102507811,3m_before,0,11,0,11,0,0
102507811,60m_before,0,218,0,218,0,0
102508004,3m_after,0,12,0,12,0,0
102508004,3m_before,0,10,0,10,0,0
102508004,60m_before,0,218,0,218,0,0
102508041,3m_after,0,11,0,11,0,0
102508041,3m_before,0,10,0,10,0,0
102508041,60m_before,0,218,0,218,0,0
102508127,3m_after,0,11,0,11,0,0
102508127,3m_before,0,12,0,12,0,0
102508127,60m_before,0,232,0,232,0,0
102508130,3m_after,0,11,0,11,0,0
102508130,3m_before,0,12,0,12,0,0
102508130,60m_before,0,66,0,66,0,0
102508154,60m_before,0,30,0,30,0,0
102508163,3m_after,0,9,0,9,0,0
102508163,3m_before,0,4,0,4,0,0
102508163,60m_before,0,52,0,52,0,0
102508220,3m_after,0,12,0,12,0,0
102508220,3m_before,0,11,0,11,0,0
102508220,60m_before,0,180,0,180,0,0
102508247,3m_after,0,22,0,22,0,0
102508247,3m_before,0,24,0,24,0,0
102508247,60m_before,0,183,0,183,0,0
102508284,3m_before,0,2,0,2,0,0
102508284,60m_before,0,141,0,141,0,0
102508340,3m_after,0,11,0,11,0,0
102508340,3m_before,0,12,0,12,0,0
102508340,60m_before,3,181,0,184,3,0
102508367,3m_after,0,12,0,12,0,0
102508367,3m_before,0,12,0,12,0,0
102508367,60m_before,0,233,0,233,0,0
102508438,3m_after,0,11,0,11,0,0
102508438,3m_before,0,12,0,12,0,0
102508438,60m_before,0,217,0,217,0,0
102508439,3m_after,0,11,0,11,0,0
102508439,3m_before,0,11,0,11,0,0
102508439,60m_before,0,229,0,229,0,0
102508444,60m_before,0,7,0,7,0,0
102508547,3m_after,0,12,0,12,0,0
102508547,3m_before,0,11,0,11,0,0
102508547,60m_before,0,228,0,228,0,0
102508610,3m_after,0,11,0,11,0,0
102508610,3m_before,0,11,0,11,0,0
102508610,60m_before,1,143,0,144,1,0
102508623,3m_after,0,1,0,1,0,0
102508623,3m_before,0,5,0,5,0,0
102508623,60m_before,0,26,0,26,0,0
102508624,3m_after,0,12,0,12,0,0
102508624,3m_before,0,12,0,12,0,0
102508624,60m_before,0,233,0,233,0,0
102508729,3m_after,0,12,0,12,0,0
102508729,3m_before,0,12,0,12,0,0
102508729,60m_before,0,233,0,233,0,0
102508784,60m_before,0,26,0,26,0,0
102508809,3m_after,0,20,0,20,0,0
102508809,3m_before,0,24,0,24,0,0
102508809,60m_before,0,408,0,408,0,0
102508810,3m_after,0,12,0,12,0,0
102508810,3m_before,0,12,0,12,0,0
102508810,60m_before,0,227,0,227,0,0
102508818,3m_after,0,11,0,11,0,0
102508818,3m_before,0,10,0,10,0,0
102508818,60m_before,0,203,0,203,0,0
102508914,3m_after,0,6,0,6,0,0
102508914,3m_before,0,12,0,12,0,0
102508914,60m_before,0,219,0,219,0,0
102508939,3m_after,0,8,0,8,0,0
102508939,3m_before,1,1,0,2,1,0
102508939,60m_before,2,127,0,129,2,0
102509003,3m_after,0,11,0,11,0,0
102509003,3m_before,0,11,0,11,0,0
102509003,60m_before,1,227,0,228,0,1
102509212,60m_before,1,30,0,31,1,0
102509251,60m_before,1,4,0,5,1,0
102509312,3m_after,0,11,0,11,0,0
102509312,3m_before,1,8,0,9,1,0
102509312,60m_before,5,192,0,197,5,0
102509424,3m_after,0,11,0,11,0,0
102509424,3m_before,0,11,0,11,0,0
102509424,60m_before,0,227,0,227,0,0
102509444,60m_before,0,24,0,24,0,0
102509472,3m_after,0,11,0,11,0,0
102509472,3m_before,0,12,0,12,0,0
102509472,60m_before,0,229,0,229,0,0
102509488,3m_after,0,12,0,12,0,0
102509488,3m_before,0,12,0,12,0,0
102509488,60m_before,1,228,0,229,1,0
102509500,3m_after,0,12,0,12,0,0
102509500,3m_before,0,11,0,11,0,0
102509500,60m_before,0,148,0,148,0,0
102509607,3m_after,0,11,0,11,0,0
102509607,3m_before,0,10,0,10,0,0
102509607,60m_before,5,191,0,196,5,0
102509618,3m_after,0,11,0,11,0,0
102509618,3m_before,0,12,0,12,0,0
102509618,60m_before,0,226,0,226,0,0
102509663,60m_before,0,26,0,26,0,0
102509822,3m_after,0,11,0,11,0,0
102509822,3m_before,0,11,0,11,0,0
102509822,60m_before,0,220,0,220,0,0
102509823,3m_after,0,11,0,11,0,0
102509823,3m_before,0,12,0,12,0,0
102509823,60m_before,0,235,0,235,0,0
102509829,3m_after,0,12,0,12,0,0
102509829,3m_before,0,12,0,12,0,0
102509829,60m_before,0,226,0,226,0,0
102509879,3m_after,0,11,0,11,0,0
102509879,3m_before,0,12,0,12,0,0
102509879,60m_before,1,57,0,58,1,0
102509880,3m_after,2,16,0,18,2,0
102509880,3m_before,0,22,0,22,0,0
102509880,60m_before,8,287,0,295,8,0
102509881,3m_after,0,11,0,11,0,0
102509881,3m_before,0,12,0,12,0,0
102509881,60m_before,0,229,0,229,0,0
102509883,3m_after,0,11,0,11,0,0
102509883,3m_before,0,12,0,12,0,0
102509883,60m_before,0,223,0,223,0,0
102509891,3m_after,0,11,0,11,0,0
102509891,3m_before,0,12,0,12,0,0
102509891,60m_before,13,124,0,137,13,0
102509950,3m_before,0,12,0,12,0,0
102509950,60m_before,0,125,0,125,0,0
102509975,60m_before,0,168,0,168,0,0
102510190,3m_after,0,12,0,12,0,0
102510190,3m_before,0,12,0,12,0,0
102510190,60m_before,0,234,0,234,0,0
102510195,3m_after,0,11,0,11,0,0
102510195,3m_before,0,12,0,12,0,0
102510195,60m_before,0,164,0,164,0,0
102510261,3m_after,0,11,0,11,0,0
102510261,3m_before,0,12,0,12,0,0
102510261,60m_before,1,229,0,230,1,0
102510286,3m_after,0,12,0,12,0,0
102510286,3m_before,0,12,0,12,0,0
102510286,60m_before,0,226,0,226,0,0
102510295,3m_after,0,11,0,11,0,0
102510295,3m_before,0,11,0,11,0,0
102510295,60m_before,0,223,0,223,0,0
102510315,3m_after,0,10,0,10,0,0
102510315,60m_before,0,12,0,12,0,0
102510447,3m_after,0,12,0,12,0,0
102510447,3m_before,0,12,0,12,0,0
102510447,60m_before,1,228,0,229,1,0
102510481,3m_after,0,11,0,11,0,0
102510481,3m_before,0,12,0,12,0,0
102510481,60m_before,1,229,0,230,1,0
102510510,60m_before,1,118,0,119,1,0
102510591,3m_after,0,11,0,11,0,0
102510591,3m_before,0,5,0,5,0,0
102510591,60m_before,0,35,0,35,0,0
102510592,3m_after,0,9,0,9,0,0
102510592,3m_before,0,3,0,3,0,0
102510592,60m_before,0,204,0,204,0,0
102510635,3m_after,0,12,0,12,0,0
102510635,3m_before,0,12,0,12,0,0
102510635,60m_before,1,229,0,230,1,0
102510688,3m_after,0,10,0,10,0,0
102510688,3m_before,0,1,0,1,0,0
102510688,60m_before,0,13,0,13,0,0
102510718,3m_after,0,10,0,10,0,0
102510718,3m_before,0,11,0,11,0,0
102510718,60m_before,0,220,0,220,0,0
102510722,3m_after,0,11,0,11,0,0
102510722,3m_before,0,12,0,12,0,0
102510722,60m_before,0,232,0,232,0,0
102510738,3m_after,0,11,0,11,0,0
102510738,3m_before,0,12,0,12,0,0
102510738,60m_before,0,229,0,229,0,0
102510799,3m_after,0,11,0,11,0,0
102510799,3m_before,0,12,0,12,0,0
102510799,60m_before,1,229,0,230,1,0
102510811,3m_after,0,12,0,12,0,0
102510811,3m_before,0,12,0,12,0,0
102510811,60m_before,0,234,0,234,0,0
102510822,3m_after,0,11,0,11,0,0
102510822,3m_before,0,12,0,12,0,0
102510822,60m_before,1,229,0,230,1,0
102510842,3m_after,0,12,0,12,0,0
102510842,3m_before,0,11,0,11,0,0
102510842,60m_before,6,155,0,161,0,6
102510872,3m_after,0,12,0,12,0,0
102510872,3m_before,0,11,0,11,0,0
102510872,60m_before,1,232,0,233,1,0
102510894,3m_after,0,10,0,10,0,0
102510894,3m_before,0,12,0,12,0,0
102510894,60m_before,1,99,0,100,0,1
102510954,3m_after,0,11,0,11,0,0
102510954,3m_before,0,11,0,11,0,0
102510954,60m_before,0,224,0,224,0,0
102510998,3m_after,0,9,0,9,0,0
102510998,3m_before,0,2,0,2,0,0
102510998,60m_before,0,14,0,14,0,0
102511006,3m_after,0,12,0,12,0,0
102511006,3m_before,0,12,0,12,0,0
102511006,60m_before,0,213,0,213,0,0
102511020,3m_after,0,11,0,11,0,0
102511020,3m_before,0,12,0,12,0,0
102511020,60m_before,0,209,0,209,0,0
102511107,3m_after,0,11,0,11,0,0
102511107,60m_before,0,12,0,12,0,0
102511154,3m_after,0,10,0,10,0,0
102511187,3m_after,0,7,0,7,0,0
102511187,3m_before,0,9,0,9,0,0
102511187,60m_before,1,223,0,224,1,0
102511203,3m_after,0,8,0,8,0,0
102511203,3m_before,0,9,0,9,0,0
102511203,60m_before,0,201,0,201,0,0
102511339,60m_before,0,34,2,36,0,2
102511418,3m_after,0,9,0,9,0,0
102511418,3m_before,0,2,0,2,0,0
102511418,60m_before,0,14,0,14,0,0
102511423,3m_after,0,8,0,8,0,0
102511423,3m_before,1,6,0,7,1,0
102511423,60m_before,14,144,0,158,14,0
102511487,3m_after,0,11,0,11,0,0
102511487,3m_before,0,11,0,11,0,0
102511487,60m_before,0,224,0,224,0,0
102511511,3m_after,0,6,0,6,0,0
102511511,3m_before,0,5,0,5,0,0
102511511,60m_before,0,17,0,17,0,0
102511693,3m_after,0,12,0,12,0,0
102511693,3m_before,0,12,0,12,0,0
102511693,60m_before,0,151,0,151,0,0
102511752,3m_after,0,12,0,12,0,0
102511752,3m_before,0,11,0,11,0,0
102511752,60m_before,0,114,1,115,0,1
102511809,3m_after,0,11,0,11,0,0
102511809,3m_before,0,12,0,12,0,0
102511809,60m_before,1,229,0,230,1,0
102511854,3m_after,0,11,0,11,0,0
102511854,3m_before,0,12,0,12,0,0
102511854,60m_before,1,228,0,229,1,0
102511909,3m_after,0,12,0,12,0,0
102511909,3m_before,0,11,0,11,0,0
102511909,60m_before,0,229,0,229,0,0
102511982,60m_before,1,26,0,27,1,0
102512108,60m_before,0,96,0,96,0,0
102512119,3m_after,0,10,0,10,0,0
102512119,3m_before,0,11,0,11,0,0
102512119,60m_before,1,94,0,95,0,1
102512267,3m_before,0,10,0,10,0,0
102512267,60m_before,0,23,0,23,0,0
102512280,3m_after,0,11,0,11,0,0
102512280,3m_before,0,11,0,11,0,0
102512280,60m_before,0,219,0,219,0,0
102512282,3m_after,0,8,0,8,0,0
102512282,3m_before,0,5,0,5,0,0
102512282,60m_before,0,193,0,193,0,0
102512343,60m_before,0,47,0,47,0,0
102512356,3m_after,0,11,0,11,0,0
102512356,3m_before,0,10,0,10,0,0
102512356,60m_before,4,194,0,198,4,0
102512392,60m_before,0,76,0,76,0,0
102512405,3m_after,0,12,0,12,0,0
102512405,3m_before,0,11,0,11,0,0
102512405,60m_before,0,218,0,218,0,0
102512459,3m_after,0,12,0,12,0,0
102512459,3m_before,0,11,0,11,0,0
102512459,60m_before,0,96,0,96,0,0
102512488,60m_before,1,3,0,4,1,0
102512559,3m_after,0,11,0,11,0,0
102512559,3m_before,0,12,0,12,0,0
102512559,60m_before,0,231,0,231,0,0
102512573,3m_after,0,11,0,11,0,0
102512573,3m_before,0,12,0,12,0,0
102512573,60m_before,0,230,0,230,0,0
102512639,3m_after,0,11,0,11,0,0
102512639,3m_before,0,12,0,12,0,0
102512639,60m_before,0,229,0,229,0,0
102512660,3m_after,0,12,0,12,0,0
102512660,3m_before,0,11,0,11,0,0
102512660,60m_before,5,165,0,170,0,5
102512694,3m_after,0,11,0,11,0,0
102512694,3m_before,0,11,0,11,0,0
102512694,60m_before,0,229,0,229,0,0
102512718,3m_after,0,12,0,12,0,0
102512718,3m_before,0,11,0,11,0,0
102512718,60m_before,0,232,0,232,0,0
102512721,3m_before,0,3,0,3,0,0
102512721,60m_before,0,19,0,19,0,0
102512803,3m_after,0,3,0,3,0,0
102512813,3m_after,0,11,0,11,0,0
102512813,3m_before,0,8,0,8,0,0
102512813,60m_before,0,189,0,189,0,0
102512901,3m_before,0,5,0,5,0,0
102512901,60m_before,0,33,0,33,0,0
102513018,3m_after,0,22,0,22,0,0
102513018,3m_before,0,24,0,24,0,0
102513018,60m_before,0,281,0,281,0,0
102513031,3m_before,0,3,0,3,0,0
102513031,60m_before,0,33,0,33,0,0
102513056,3m_after,0,12,0,12,0,0
102513056,3m_before,0,11,0,11,0,0
102513056,60m_before,0,220,0,220,0,0
102513215,3m_after,0,12,0,12,0,0
102513215,3m_before,0,12,0,12,0,0
102513215,60m_before,0,232,0,232,0,0
102513232,3m_after,0,11,0,11,0,0
102513232,3m_before,0,10,0,10,0,0
102513232,60m_before,0,189,0,189,0,0
102513298,60m_before,0,19,0,19,0,0
102513368,60m_before,0,19,0,19,0,0
102513465,3m_after,0,11,0,11,0,0
102513465,3m_before,0,11,0,11,0,0
102513465,60m_before,0,221,0,221,0,0
102513513,3m_after,0,10,0,10,0,0
102513513,3m_before,0,11,0,11,0,0
102513513,60m_before,4,195,0,199,4,0
102513708,3m_after,0,11,0,11,0,0
102513708,3m_before,0,12,0,12,0,0
102513708,60m_before,0,228,0,228,0,0
102513715,3m_after,0,11,0,11,0,0
102513715,3m_before,0,11,0,11,0,0
102513715,60m_before,0,189,0,189,0,0
102513721,3m_after,0,11,0,11,0,0
102513721,3m_before,0,12,0,12,0,0
102513721,60m_before,0,235,0,235,0,0
102513731,3m_after,0,11,0,11,0,0
102513731,3m_before,0,11,0,11,0,0
102513731,60m_before,0,218,0,218,0,0
102513750,3m_after,0,12,0,12,0,0
102513750,3m_before,0,11,0,11,0,0
102513750,60m_before,0,232,0,232,0,0
102513775,3m_after,0,11,0,11,0,0
102513775,3m_before,0,12,0,12,0,0
102513775,60m_before,0,230,0,230,0,0
102513821,3m_after,0,12,0,12,0,0
102513821,3m_before,0,11,0,11,0,0
102513821,60m_before,0,189,0,189,0,0
102513836,3m_after,0,12,0,12,0,0
102513836,3m_before,0,12,0,12,0,0
102513836,60m_before,0,218,0,218,0,0
102513880,60m_before,0,19,0,19,0,0
102513892,3m_after,0,11,0,11,0,0
102513892,3m_before,0,12,0,12,0,0
102513892,60m_before,0,229,0,229,0,0
102514278,3m_after,0,6,0,6,0,0
102514278,3m_before,1,7,0,8,1,0
102514278,60m_before,11,163,0,174,11,0
102514281,60m_before,0,19,0,19,0,0
102514305,3m_after,1,7,0,8,1,0
102514305,3m_before,0,11,0,11,0,0
102514305,60m_before,4,195,0,199,4,0
102514315,3m_after,0,11,0,11,0,0
102514315,3m_before,0,12,0,12,0,0
102514315,60m_before,0,90,0,90,0,0
102514425,3m_after,0,11,0,11,0,0
102514425,3m_before,0,11,0,11,0,0
102514425,60m_before,0,189,0,189,0,0
102514462,3m_after,0,12,0,12,0,0
102514462,3m_before,0,11,0,11,0,0
102514462,60m_before,0,234,0,234,0,0
102514480,3m_after,0,11,0,11,0,0
102514480,3m_before,0,12,0,12,0,0
102514480,60m_before,0,189,0,189,0,0
102514491,3m_after,0,5,0,5,0,0
102514491,60m_before,3,23,0,26,2,1
102514660,3m_after,0,11,0,11,0,0
102514660,3m_before,0,11,0,11,0,0
102514660,60m_before,0,233,0,233,0,0
102514680,3m_after,0,8,0,8,0,0
102514680,60m_before,2,11,0,13,1,1
102514800,3m_after,0,11,0,11,0,0
102514800,3m_before,0,12,0,12,0,0
102514800,60m_before,0,229,0,229,0,0
102514828,3m_after,0,4,0,4,0,0
102514828,3m_before,0,5,0,5,0,0
102514828,60m_before,2,16,0,18,1,1
102514861,3m_after,0,11,0,11,0,0
102514861,3m_before,0,12,0,12,0,0
102514861,60m_before,0,235,0,235,0,0
102514893,3m_after,0,12,0,12,0,0
102514893,3m_before,0,11,0,11,0,0
102514893,60m_before,1,228,0,229,1,0
102514917,60m_before,0,19,0,19,0,0
102514952,3m_after,0,12,0,12,0,0
102514952,3m_before,0,11,0,11,0,0
102514952,60m_before,0,233,0,233,0,0
102514978,3m_after,0,11,0,11,0,0
102514978,3m_before,0,12,0,12,0,0
102514978,60m_before,0,233,0,233,0,0
102515100,3m_after,0,11,0,11,0,0
102515100,3m_before,0,12,0,12,0,0
102515100,60m_before,0,52,0,52,0,0
102515213,3m_after,0,11,0,11,0,0
102515213,3m_before,0,12,0,12,0,0
102515213,60m_before,1,229,0,230,1,0
102515284,3m_after,0,11,0,11,0,0
102515284,3m_before,0,12,0,12,0,0
102515284,60m_before,1,218,0,219,1,0
102515294,3m_after,0,12,0,12,0,0
102515294,3m_before,0,11,0,11,0,0
102515294,60m_before,0,227,0,227,0,0
102515379,3m_after,0,10,0,10,0,0
102515379,3m_before,0,11,0,11,0,0
102515379,60m_before,0,215,0,215,0,0
102515383,3m_after,0,11,0,11,0,0
102515383,3m_before,0,11,0,11,0,0
102515383,60m_before,0,222,0,222,0,0
102515420,3m_after,0,12,0,12,0,0
102515420,3m_before,0,10,0,10,0,0
102515420,60m_before,0,207,0,207,0,0
102515492,3m_after,0,12,0,12,0,0
102515492,3m_before,0,11,0,11,0,0
102515492,60m_before,0,230,0,230,0,0
102515560,3m_after,0,12,0,12,0,0
102515560,3m_before,0,10,0,10,0,0
102515560,60m_before,0,185,0,185,0,0
102515704,3m_after,0,2,0,2,0,0
102515704,60m_before,0,102,0,102,0,0
102515827,3m_after,0,12,0,12,0,0
102515827,3m_before,0,12,0,12,0,0
102515827,60m_before,0,232,0,232,0,0
102516170,3m_after,0,10,0,10,0,0
102516170,3m_before,0,12,0,12,0,0
102516170,60m_before,0,188,0,188,0,0
102516251,3m_after,0,12,0,12,0,0
102516251,3m_before,0,12,0,12,0,0
102516251,60m_before,0,232,0,232,0,0
102516323,3m_after,0,11,0,11,0,0
102516323,3m_before,0,11,0,11,0,0
102516323,60m_before,0,188,0,188,0,0
102516473,3m_after,0,12,0,12,0,0
102516473,3m_before,0,12,0,12,0,0
102516473,60m_before,0,233,0,233,0,0
102516534,3m_after,0,11,0,11,0,0
102516534,3m_before,0,12,0,12,0,0
102516534,60m_before,0,230,0,230,0,0
102516870,3m_after,0,11,0,11,0,0
102516870,3m_before,0,12,0,12,0,0
102516870,60m_before,0,106,0,106,0,0
102516871,3m_after,0,11,0,11,0,0
102516871,3m_before,0,12,0,12,0,0
102516871,60m_before,0,182,0,182,0,0
102516997,3m_after,1,3,0,4,1,0
102516997,3m_before,1,2,0,3,1,0
102516997,60m_before,11,155,0,166,11,0
102517034,3m_before,0,2,0,2,0,0
102517034,60m_before,0,15,0,15,0,0
102517104,60m_before,1,173,0,174,1,0
102517157,3m_after,0,12,0,12,0,0
102517157,3m_before,0,12,0,12,0,0
102517157,60m_before,0,230,0,230,0,0
102517161,3m_after,0,1,0,1,0,0
102517161,3m_before,0,3,0,3,0,0
102517161,60m_before,0,14,0,14,0,0
102517170,3m_after,0,11,0,11,0,0
102517170,3m_before,0,11,0,11,0,0
102517170,60m_before,0,222,0,222,0,0
102517171,3m_after,0,12,0,12,0,0
102517171,3m_before,0,11,0,11,0,0
102517171,60m_before,6,158,0,164,0,6
102517173,3m_after,0,2,0,2,0,0
102517173,60m_before,0,150,0,150,0,0
102517174,3m_after,0,8,0,8,0,0
102517174,3m_before,1,5,0,6,1,0
102517174,60m_before,11,155,0,166,11,0
102517429,3m_before,0,1,0,1,0,0
102517429,60m_before,0,135,0,135,0,0
102517453,3m_before,0,2,0,2,0,0
102517453,60m_before,0,15,0,15,0,0
102517478,60m_before,2,41,0,43,2,0
102517631,3m_after,0,12,0,12,0,0
102517631,3m_before,0,11,0,11,0,0
102517631,60m_before,0,233,0,233,0,0
102517633,3m_before,0,9,0,9,0,0
102517633,60m_before,0,21,0,21,0,0
102517663,3m_after,0,11,0,11,0,0
102517663,3m_before,0,12,0,12,0,0
102517663,60m_before,0,232,0,232,0,0
102517733,3m_after,0,12,0,12,0,0
102517733,3m_before,0,12,0,12,0,0
102517733,60m_before,0,232,0,232,0,0
102517782,3m_after,0,11,0,11,0,0
102517782,3m_before,0,10,0,10,0,0
102517782,60m_before,4,197,0,201,4,0
102517814,3m_after,0,10,0,10,0,0
102517814,60m_before,0,417,0,417,0,0
102517889,3m_after,0,6,0,6,0,0
102518073,60m_before,0,15,0,15,0,0
102518098,3m_after,0,3,0,3,0,0
102518098,3m_before,1,0,0,1,1,0
102518098,60m_before,4,20,0,24,4,0
102518099,60m_before,0,15,0,15,0,0
102518200,60m_before,0,15,0,15,0,0
102518298,3m_after,0,12,0,12,0,0
102518298,3m_before,0,10,0,10,0,0
102518298,60m_before,1,212,0,213,0,1
102518395,60m_before,0,202,0,202,0,0
102518497,3m_after,0,11,0,11,0,0
102518497,3m_before,0,12,0,12,0,0
102518497,60m_before,0,231,0,231,0,0
102518630,60m_before,0,15,0,15,0,0
102518682,3m_after,0,12,0,12,0,0
102518682,3m_before,0,12,0,12,0,0
102518682,60m_before,0,229,0,229,0,0
102518691,60m_before,0,15,0,15,0,0
102518763,60m_before,0,15,0,15,0,0
102518766,3m_after,0,12,0,12,0,0
102518766,3m_before,0,12,0,12,0,0
102518766,60m_before,0,236,0,236,0,0
102518829,3m_before,0,8,0,8,0,0
102518829,60m_before,0,226,0,226,0,0
102518958,3m_after,0,11,0,11,0,0
102518958,3m_before,0,11,0,11,0,0
102518958,60m_before,9,163,0,172,9,0
102519087,60m_before,0,189,0,189,0,0
102519161,3m_before,0,2,0,2,0,0
102519161,60m_before,0,219,0,219,0,0
102519166,3m_after,0,8,0,8,0,0
102519166,3m_before,0,22,0,22,0,0
102519166,60m_before,0,30,0,30,0,0
102519266,3m_after,0,8,0,8,0,0
102519266,3m_before,0,3,0,3,0,0
102519266,60m_before,0,175,0,175,0,0
102519329,3m_after,0,10,0,10,0,0
102519329,3m_before,0,10,0,10,0,0
102519329,60m_before,2,51,0,53,2,0
102519511,3m_after,0,12,0,12,0,0
102519511,3m_before,0,12,0,12,0,0
102519511,60m_before,0,233,0,233,0,0
102519513,3m_after,0,10,0,10,0,0
102519513,3m_before,0,11,0,11,0,0
102519513,60m_before,0,217,0,217,0,0
102519573,60m_before,0,180,0,180,0,0
102519579,3m_after,0,11,0,11,0,0
102519579,3m_before,0,12,0,12,0,0
102519579,60m_before,0,222,0,222,0,0
102519596,3m_after,0,11,0,11,0,0
102519596,3m_before,0,12,0,12,0,0
102519596,60m_before,0,224,0,224,0,0
102519715,3m_after,0,8,0,8,0,0
102519715,60m_before,0,74,0,74,0,0
102519727,3m_after,0,11,0,11,0,0
102519727,3m_before,0,6,0,6,0,0
102519727,60m_before,0,172,0,172,0,0
102519771,3m_after,0,12,0,12,0,0
102519771,3m_before,0,11,0,11,0,0
102519771,60m_before,0,228,0,228,0,0
102519932,3m_after,0,11,0,11,0,0
102519932,3m_before,0,10,0,10,0,0
102519932,60m_before,0,173,0,173,0,0
102520010,3m_after,0,1,0,1,0,0
102520010,60m_before,2,42,0,44,2,0
102520111,3m_after,0,11,0,11,0,0
102520111,3m_before,0,11,0,11,0,0
102520111,60m_before,1,212,0,213,0,1
102520128,3m_after,0,11,0,11,0,0
102520128,3m_before,0,12,0,12,0,0
102520128,60m_before,0,229,0,229,0,0
102520403,3m_after,2,2,0,4,2,0
102520403,3m_before,2,4,0,6,2,0
102520403,60m_before,14,154,0,168,14,0
102520421,60m_before,0,21,0,21,0,0
102520496,60m_before,1,46,0,47,1,0
102520548,3m_after,0,10,0,10,0,0
102520548,3m_before,0,11,0,11,0,0
102520548,60m_before,3,203,0,206,3,0
102520552,3m_after,0,12,0,12,0,0
102520552,3m_before,0,10,0,10,0,0
102520552,60m_before,0,230,0,230,0,0
102520607,3m_after,1,4,0,5,1,0
102520607,3m_before,2,5,0,7,2,0
102520607,60m_before,15,151,0,166,15,0
102520793,3m_after,0,4,0,4,0,0
102520793,3m_before,0,2,0,2,0,0
102520793,60m_before,0,57,0,57,0,0
102520863,3m_after,0,11,0,11,0,0
102520863,3m_before,0,7,0,7,0,0
102520863,60m_before,1,114,0,115,1,0
102520965,60m_before,0,204,0,204,0,0
102520977,60m_before,0,156,0,156,0,0
102521278,3m_before,0,2,0,2,0,0
102521278,60m_before,0,29,0,29,0,0
102521343,60m_before,0,29,0,29,0,0
102521360,3m_after,0,5,0,5,0,0
102521360,60m_before,0,21,0,21,0,0
102521397,3m_after,0,11,0,11,0,0
102521397,3m_before,0,12,0,12,0,0
102521397,60m_before,1,174,0,175,0,1
102521410,3m_after,0,12,0,12,0,0
102521410,3m_before,0,11,0,11,0,0
102521410,60m_before,1,212,0,213,0,1
102521629,3m_after,0,11,0,11,0,0
102521629,3m_before,0,10,0,10,0,0
102521629,60m_before,0,216,0,216,0,0
102521657,3m_after,0,12,0,12,0,0
102521657,3m_before,0,11,0,11,0,0
102521657,60m_before,0,229,0,229,0,0
102521658,3m_after,0,3,0,3,0,0
102521658,3m_before,0,7,0,7,0,0
102521658,60m_before,0,58,0,58,0,0
102521678,3m_after,0,11,0,11,0,0
102521678,3m_before,0,12,0,12,0,0
102521678,60m_before,0,230,0,230,0,0
102521698,3m_after,0,11,0,11,0,0
102521698,3m_before,0,12,0,12,0,0
102521698,60m_before,0,233,0,233,0,0
102521758,3m_before,0,2,0,2,0,0
102521758,60m_before,0,29,0,29,0,0
102521871,3m_after,0,7,0,7,0,0
102521871,3m_before,0,7,0,7,0,0
102521871,60m_before,0,57,0,57,0,0
102521902,3m_after,1,1,0,2,1,0
102521902,3m_before,0,3,0,3,0,0
102521902,60m_before,17,135,0,152,17,0
102521958,3m_after,0,11,0,11,0,0
102521958,3m_before,0,11,0,11,0,0
102521958,60m_before,1,212,0,213,0,1
102521986,3m_after,0,12,0,12,0,0
102521986,3m_before,0,12,0,12,0,0
102521986,60m_before,0,184,0,184,0,0
102522070,60m_before,1,0,0,1,1,0
102522118,3m_after,0,12,0,12,0,0
102522118,3m_before,0,12,0,12,0,0
102522118,60m_before,1,226,0,227,0,1
102522393,3m_after,0,6,0,6,0,0
102522393,60m_before,0,124,0,124,0,0
102522423,3m_after,0,12,0,12,0,0
102522423,3m_before,0,11,0,11,0,0
102522423,60m_before,0,232,0,232,0,0
102522455,3m_after,0,11,0,11,0,0
102522455,3m_before,0,12,0,12,0,0
102522455,60m_before,0,233,0,233,0,0
102522482,3m_after,0,11,0,11,0,0
102522482,3m_before,0,12,0,12,0,0
102522482,60m_before,0,233,0,233,0,0
102522558,3m_after,0,11,0,11,0,0
102522558,3m_before,0,11,0,11,0,0
102522558,60m_before,0,233,0,233,0,0
102522672,3m_after,0,10,0,10,0,0
102522672,3m_before,0,10,0,10,0,0
102522672,60m_before,0,219,0,219,0,0
102522988,3m_after,0,12,0,12,0,0
102522988,3m_before,0,12,0,12,0,0
102522988,60m_before,0,232,0,232,0,0
102523053,3m_after,0,12,0,12,0,0
102523053,3m_before,0,11,0,11,0,0
102523053,60m_before,0,230,0,230,0,0
102523133,3m_after,0,10,0,10,0,0
102523133,3m_before,0,11,0,11,0,0
102523133,60m_before,0,217,0,217,0,0
102523177,3m_after,0,12,0,12,0,0
102523207,3m_after,0,12,0,12,0,0
102523207,3m_before,0,11,0,11,0,0
102523207,60m_before,0,232,0,232,0,0
102523220,60m_before,0,29,0,29,0,0
102523334,3m_after,0,11,0,11,0,0
102523334,3m_before,0,10,0,10,0,0
102523334,60m_before,0,218,0,218,0,0
102523490,60m_before,0,106,0,106,0,0
102523560,3m_after,0,12,0,12,0,0
102523560,3m_before,0,11,0,11,0,0
102523560,60m_before,0,108,0,108,0,0
102523656,3m_after,0,12,0,12,0,0
102523656,3m_before,0,12,0,12,0,0
102523656,60m_before,0,229,0,229,0,0
102523786,3m_after,0,12,0,12,0,0
102523786,3m_before,0,11,0,11,0,0
102523786,60m_before,0,232,0,232,0,0
102523788,60m_before,0,25,0,25,0,0
102523810,3m_after,0,11,0,11,0,0
102523810,3m_before,0,12,0,12,0,0
102523810,60m_before,0,230,0,230,0,0
102523831,3m_after,0,23,0,23,0,0
102523831,3m_before,0,23,0,23,0,0
102523831,60m_before,0,405,0,405,0,0
102523842,3m_after,0,8,0,8,0,0
102523842,3m_before,0,11,0,11,0,0
102523842,60m_before,0,199,0,199,0,0
102524086,60m_before,3,2,0,5,3,0
102524107,3m_after,2,2,0,4,2,0
102524107,3m_before,1,8,0,9,1,0
102524107,60m_before,1,224,0,225,1,0
102524208,3m_after,0,11,0,11,0,0
102524208,60m_before,0,88,0,88,0,0
102524243,3m_after,0,12,0,12,0,0
102524243,3m_before,0,11,0,11,0,0
102524243,60m_before,0,203,0,203,0,0
102524244,3m_after,0,11,0,11,0,0
102524244,3m_before,1,5,0,6,1,0
102524244,60m_before,10,151,0,161,10,0
102524269,3m_after,0,12,0,12,0,0
102524269,3m_before,0,11,0,11,0,0
102524269,60m_before,0,232,0,232,0,0
102524331,60m_before,1,2,0,3,1,0
102524478,3m_after,0,7,0,7,0,0
102524478,3m_before,0,4,0,4,0,0
102524478,60m_before,0,125,0,125,0,0
102524486,3m_before,0,10,0,10,0,0
102524486,60m_before,20,125,0,145,20,0
102524488,3m_after,0,12,0,12,0,0
102524488,3m_before,0,10,0,10,0,0
102524488,60m_before,0,230,0,230,0,0
102524583,3m_after,0,10,0,10,0,0
102524583,3m_before,0,12,0,12,0,0
102524583,60m_before,0,229,0,229,0,0
102524685,3m_after,0,7,0,7,0,0
102524685,3m_before,0,1,1,2,0,1
102524685,60m_before,0,7,1,8,0,1
102524716,60m_before,0,18,0,18,0,0
102524773,60m_before,0,18,0,18,0,0
102524817,3m_after,0,9,0,9,0,0
102524817,3m_before,0,4,0,4,0,0
102524817,60m_before,0,198,0,198,0,0
102524849,3m_after,0,11,0,11,0,0
102524849,3m_before,0,10,0,10,0,0
102524849,60m_before,0,217,0,217,0,0
102524851,3m_before,0,1,0,1,0,0
102524851,60m_before,0,49,0,49,0,0
102524885,3m_after,0,11,0,11,0,0
102524885,3m_before,0,11,0,11,0,0
102524885,60m_before,0,215,0,215,0,0
102524973,3m_after,0,7,0,7,0,0
102524973,3m_before,0,10,0,10,0,0
102524973,60m_before,0,233,0,233,0,0
102525065,3m_before,0,3,0,3,0,0
102525065,60m_before,2,197,0,199,2,0
102525144,3m_after,0,10,0,10,0,0
102525144,3m_before,0,12,0,12,0,0
102525144,60m_before,4,193,0,197,2,2
102525178,3m_after,0,5,0,5,0,0
102525178,3m_before,0,1,0,1,0,0
102525178,60m_before,0,29,0,29,0,0
102525270,60m_before,0,18,0,18,0,0
102525276,3m_after,0,12,0,12,0,0
102525276,3m_before,0,11,0,11,0,0
102525276,60m_before,0,228,0,228,0,0
102525336,3m_after,0,11,0,11,0,0
102525336,3m_before,0,12,0,12,0,0
102525336,60m_before,0,233,0,233,0,0
102525382,3m_after,0,12,0,12,0,0
102525382,3m_before,0,11,0,11,0,0
102525382,60m_before,0,227,0,227,0,0
102525637,3m_after,0,12,0,12,0,0
102525637,3m_before,0,11,0,11,0,0
102525637,60m_before,0,229,0,229,0,0
102525697,3m_after,0,10,0,10,0,0
102525697,3m_before,0,11,0,11,0,0
102525697,60m_before,16,113,0,129,16,0
102525828,3m_after,0,12,0,12,0,0
102525828,3m_before,0,12,0,12,0,0
102525828,60m_before,0,230,0,230,0,0
102525944,60m_before,0,18,0,18,0,0
102525963,60m_before,0,55,0,55,0,0
102526040,3m_after,0,11,0,11,0,0
102526040,3m_before,0,12,0,12,0,0
102526040,60m_before,0,232,0,232,0,0
102526194,3m_after,0,11,0,11,0,0
102526194,3m_before,0,11,0,11,0,0
102526194,60m_before,4,139,0,143,4,0
102526257,3m_after,0,11,0,11,0,0
102526257,3m_before,0,11,0,11,0,0
102526257,60m_before,0,92,0,92,0,0
102526346,3m_before,0,1,0,1,0,0
102526346,60m_before,0,130,0,130,0,0
102526435,3m_before,1,8,0,9,1,0
102526435,60m_before,20,292,0,312,20,0
102526505,60m_before,0,18,0,18,0,0
102526672,60m_before,0,18,0,18,0,0
102526716,3m_after,0,11,0,11,0,0
102526716,3m_before,0,11,0,11,0,0
102526716,60m_before,0,216,0,216,0,0
102526982,3m_after,0,24,0,24,0,0
102526982,3m_before,0,22,0,22,0,0
102526982,60m_before,0,404,0,404,0,0
102527050,3m_after,1,7,0,8,1,0
102527050,3m_before,0,8,0,8,0,0
102527050,60m_before,0,182,0,182,0,0
102527377,3m_after,0,12,0,12,0,0
102527377,3m_before,0,10,0,10,0,0
102527377,60m_before,0,227,0,227,0,0
102527679,3m_after,0,11,0,11,0,0
102527679,3m_before,0,12,0,12,0,0
102527679,60m_before,0,233,0,233,0,0
102527718,60m_before,0,18,0,18,0,0
102527734,3m_after,0,11,0,11,0,0
102527734,60m_before,0,205,0,205,0,0
102527745,3m_after,0,8,0,8,0,0
102527745,3m_before,0,11,0,11,0,0
102527745,60m_before,1,218,0,219,0,1
102527955,3m_after,0,10,0,10,0,0
102527955,3m_before,0,9,0,9,0,0
102527955,60m_before,1,216,0,217,0,1
102527988,3m_after,0,12,0,12,0,0
102527988,3m_before,0,11,0,11,0,0
102527988,60m_before,0,210,0,210,0,0
102528060,3m_after,2,3,0,5,2,0
102528060,3m_before,1,4,0,5,1,0
102528060,60m_before,14,112,0,126,14,0
102528134,3m_after,0,9,0,9,0,0
102528134,60m_before,0,132,0,132,0,0
102528258,3m_after,0,9,0,9,0,0
102528258,3m_before,0,11,0,11,0,0
102528258,60m_before,0,233,0,233,0,0
102528314,3m_after,0,12,0,12,0,0
102528314,3m_before,0,12,0,12,0,0
102528314,60m_before,0,227,0,227,0,0
102528374,3m_before,0,4,0,4,0,0
102528374,60m_before,0,166,0,166,0,0
102528478,60m_before,0,15,0,15,0,0
102528725,3m_before,2,0,0,2,2,0
102528725,60m_before,3,45,0,48,3,0
102528846,3m_after,0,1,0,1,0,0
102528846,3m_before,0,6,0,6,0,0
102528846,60m_before,0,48,0,48,0,0
102528883,3m_after,0,12,0,12,0,0
102528883,3m_before,0,11,0,11,0,0
102528883,60m_before,0,230,0,230,0,0
102529017,60m_before,0,38,0,38,0,0
102529048,3m_after,0,4,0,4,0,0
102529048,60m_before,0,89,0,89,0,0
102529126,3m_after,0,12,0,12,0,0
102529126,3m_before,0,11,0,11,0,0
102529126,60m_before,0,224,0,224,0,0
102529327,3m_after,0,11,0,11,0,0
102529327,3m_before,0,11,0,11,0,0
102529327,60m_before,0,217,0,217,0,0
102529359,3m_after,0,11,0,11,0,0
102529359,3m_before,0,11,0,11,0,0
102529359,60m_before,0,130,0,130,0,0
102529398,3m_after,0,11,0,11,0,0
102529398,3m_before,0,12,0,12,0,0
102529398,60m_before,0,229,0,229,0,0
102529543,3m_after,0,14,0,14,0,0
102529543,3m_before,0,11,0,11,0,0
102529543,60m_before,0,231,0,231,0,0
102529774,3m_after,0,12,0,12,0,0
102529774,3m_before,0,11,0,11,0,0
102529774,60m_before,0,238,0,238,0,0
102529837,3m_after,0,12,0,12,0,0
102529837,3m_before,0,11,0,11,0,0
102529837,60m_before,0,227,0,227,0,0
102529906,3m_after,0,11,0,11,0,0
102529906,3m_before,0,10,0,10,0,0
102529906,60m_before,0,153,0,153,0,0
102529909,3m_after,0,12,0,12,0,0
102529909,3m_before,0,11,0,11,0,0
102529909,60m_before,0,230,0,230,0,0
102530104,3m_after,0,11,0,11,0,0
102530104,3m_before,0,12,0,12,0,0
102530104,60m_before,0,228,0,228,0,0
102530186,3m_after,0,12,0,12,0,0
102530186,3m_before,0,11,0,11,0,0
102530186,60m_before,0,239,0,239,0,0
102530362,60m_before,0,14,0,14,0,0
102530374,3m_after,0,12,0,12,0,0
102530374,3m_before,0,11,0,11,0,0
102530374,60m_before,0,220,0,220,0,0
102530608,3m_after,0,9,0,9,0,0
102530608,3m_before,0,12,0,12,0,0
102530608,60m_before,0,227,0,227,0,0
102530724,60m_before,0,14,0,14,0,0
102530829,3m_after,1,9,0,10,1,0
102530829,3m_before,0,11,0,11,0,0
102530829,60m_before,0,230,0,230,0,0
102530873,3m_after,1,5,0,6,1,0
102530873,3m_before,0,10,0,10,0,0
102530873,60m_before,3,174,0,177,3,0
102530965,60m_before,0,27,0,27,0,0
102531003,3m_after,0,11,0,11,0,0
102531003,3m_before,0,12,0,12,0,0
102531003,60m_before,0,212,0,212,0,0
102531156,3m_after,0,12,0,12,0,0
102531156,3m_before,0,12,0,12,0,0
102531156,60m_before,1,105,0,106,1,0
102531181,3m_after,0,11,0,11,0,0
102531181,3m_before,0,10,0,10,0,0
102531181,60m_before,0,216,0,216,0,0
102531206,3m_after,0,12,0,12,0,0
102531206,3m_before,0,11,0,11,0,0
102531206,60m_before,0,219,0,219,0,0
102531251,3m_after,0,11,0,11,0,0
102531251,3m_before,0,12,0,12,0,0
102531251,60m_before,0,229,0,229,0,0
102531306,3m_after,0,10,0,10,0,0
102531306,3m_before,1,6,0,7,1,0
102531306,60m_before,4,172,0,176,4,0
102531406,3m_after,0,11,0,11,0,0
102531406,3m_before,1,5,0,6,1,0
102531406,60m_before,4,171,0,175,4,0
102531463,3m_after,1,6,0,7,1,0
102531463,3m_before,0,10,0,10,0,0
102531463,60m_before,16,110,0,126,16,0
102531541,3m_after,0,11,0,11,0,0
102531541,3m_before,0,7,0,7,0,0
102531541,60m_before,0,109,0,109,0,0
102531660,3m_after,0,11,0,11,0,0
102531660,3m_before,0,12,0,12,0,0
102531660,60m_before,0,231,0,231,0,0
102531724,3m_before,0,8,0,8,0,0
102531724,60m_before,8,169,0,177,4,4
102531813,60m_before,1,110,0,111,1,0
102531821,60m_before,0,13,0,13,0,0
102531835,3m_after,0,9,0,9,0,0
102531835,3m_before,0,9,0,9,0,0
102531835,60m_before,4,170,0,174,4,0
102531876,3m_after,0,11,0,11,0,0
102531876,3m_before,0,12,0,12,0,0
102531876,60m_before,0,204,0,204,0,0
102531951,3m_after,0,11,0,11,0,0
102531951,3m_before,0,11,0,11,0,0
102531951,60m_before,0,216,0,216,0,0
102531972,3m_after,0,12,0,12,0,0
102531972,3m_before,0,11,0,11,0,0
102531972,60m_before,0,230,0,230,0,0
102532049,3m_after,0,11,0,11,0,0
102532049,3m_before,0,11,0,11,0,0
102532049,60m_before,0,216,0,216,0,0
102532101,60m_before,0,56,0,56,0,0
102532103,60m_before,0,85,0,85,0,0
102532152,3m_after,1,5,0,6,1,0
102532152,3m_before,0,12,0,12,0,0
102532152,60m_before,4,187,0,191,4,0
102532225,3m_after,1,9,0,10,1,0
102532225,3m_before,0,12,0,12,0,0
102532225,60m_before,4,206,0,210,4,0
102532239,3m_after,0,11,0,11,0,0
102532239,3m_before,0,12,0,12,0,0
102532239,60m_before,0,221,0,221,0,0
102532340,3m_after,0,1,0,1,0,0
102532340,60m_before,0,33,0,33,0,0
102532417,3m_after,0,12,0,12,0,0
102532417,3m_before,0,11,0,11,0,0
102532417,60m_before,0,230,0,230,0,0
102532872,3m_after,0,12,0,12,0,0
102532872,3m_before,0,12,0,12,0,0
102532872,60m_before,0,231,0,231,0,0
102532941,60m_before,1,89,0,90,1,0
102533038,3m_after,0,11,0,11,0,0
102533038,3m_before,0,11,0,11,0,0
102533038,60m_before,4,196,0,200,4,0
102533324,3m_after,0,12,0,12,0,0
102533324,3m_before,0,11,0,11,0,0
102533324,60m_before,0,234,0,234,0,0
102533390,3m_after,0,11,0,11,0,0
102533390,3m_before,0,12,0,12,0,0
102533390,60m_before,5,212,0,217,2,3
102533558,60m_before,0,1,0,1,0,0
102533651,60m_before,2,12,0,14,2,0
102533688,3m_after,0,12,0,12,0,0
102533688,3m_before,1,8,0,9,1,0
102533688,60m_before,1,227,0,228,1,0
102533764,60m_before,0,4,0,4,0,0
102533778,3m_after,0,11,0,11,0,0
102533778,3m_before,0,11,0,11,0,0
102533778,60m_before,0,220,0,220,0,0
102533956,60m_before,0,18,0,18,0,0
102533995,3m_after,0,12,0,12,0,0
102533995,3m_before,0,11,0,11,0,0
102533995,60m_before,0,230,0,230,0,0
102534028,3m_after,0,22,0,22,0,0
102534028,3m_before,0,22,0,22,0,0
102534028,60m_before,0,146,0,146,0,0
102534049,3m_after,0,11,0,11,0,0
102534049,3m_before,0,12,0,12,0,0
102534049,60m_before,0,226,0,226,0,0
102534215,3m_after,0,2,0,2,0,0
102534215,3m_before,0,3,0,3,0,0
102534215,60m_before,0,202,0,202,0,0
102534281,3m_after,0,3,0,3,0,0
102534281,3m_before,0,1,0,1,0,0
102534281,60m_before,0,123,0,123,0,0
102534282,3m_after,0,9,0,9,0,0
102534282,3m_before,2,0,0,2,1,1
102534282,60m_before,4,199,0,203,3,1
102534301,3m_after,0,9,0,9,0,0
102534301,3m_before,2,6,0,8,2,0
102534301,60m_before,13,137,0,150,13,0
102534389,3m_after,0,12,0,12,0,0
102534389,3m_before,0,11,0,11,0,0
102534389,60m_before,5,156,0,161,2,3
102534448,3m_after,0,10,0,10,0,0
102534448,3m_before,0,11,0,11,0,0
102534448,60m_before,4,188,0,192,4,0
102534563,3m_after,0,12,0,12,0,0
102534563,3m_before,0,12,0,12,0,0
102534563,60m_before,5,203,0,208,5,0
102534649,3m_after,1,0,0,1,1,0
102534649,60m_before,4,181,0,185,4,0
102534717,3m_after,0,11,0,11,0,0
102534717,3m_before,0,11,0,11,0,0
102534717,60m_before,0,220,0,220,0,0
102534940,3m_after,0,6,0,6,0,0
102535036,3m_after,0,7,0,7,0,0
102535036,3m_before,1,0,0,1,1,0
102535036,60m_before,5,171,0,176,5,0
102535070,3m_after,0,9,0,9,0,0
102535070,3m_before,0,11,0,11,0,0
102535070,60m_before,2,220,0,222,2,0
102535212,3m_after,0,3,0,3,0,0
102535252,3m_after,0,7,0,7,0,0
102535252,3m_before,0,5,0,5,0,0
102535252,60m_before,0,49,0,49,0,0
102535562,60m_before,0,16,1,17,0,1
102535684,3m_after,0,11,0,11,0,0
102535684,3m_before,0,12,0,12,0,0
102535684,60m_before,0,231,0,231,0,0
102535727,3m_after,0,8,0,8,0,0
102535727,3m_before,0,3,0,3,0,0
102535727,60m_before,0,223,0,223,0,0
102535759,3m_after,1,6,0,7,1,0
102535759,3m_before,0,9,0,9,0,0
102535759,60m_before,4,158,0,162,4,0
102535995,3m_after,0,12,0,12,0,0
102535995,3m_before,0,6,0,6,0,0
102535995,60m_before,0,220,0,220,0,0
102536060,3m_after,0,11,0,11,0,0
102536060,3m_before,0,11,0,11,0,0
102536060,60m_before,0,191,0,191,0,0
102536188,3m_after,1,8,0,9,1,0
102536188,3m_before,0,12,0,12,0,0
102536188,60m_before,4,145,0,149,4,0
102536224,3m_after,0,12,0,12,0,0
102536224,3m_before,0,12,0,12,0,0
102536224,60m_before,0,230,0,230,0,0
102536399,3m_after,0,11,0,11,0,0
102536399,3m_before,0,10,0,10,0,0
102536399,60m_before,0,211,0,211,0,0
102536604,3m_before,0,1,0,1,0,0
102536604,60m_before,1,54,0,55,1,0
102536831,3m_before,0,1,0,1,0,0
102536831,60m_before,0,141,0,141,0,0
102537011,3m_after,0,11,0,11,0,0
102537011,3m_before,0,12,0,12,0,0
102537011,60m_before,5,156,0,161,2,3
102537028,3m_after,0,11,0,11,0,0
102537028,3m_before,0,10,0,10,0,0
102537028,60m_before,0,211,0,211,0,0
102537072,3m_after,0,12,0,12,0,0
102537072,3m_before,0,12,0,12,0,0
102537072,60m_before,0,193,0,193,0,0
102537301,3m_after,0,12,0,12,0,0
102537301,3m_before,0,12,0,12,0,0
102537301,60m_before,0,188,0,188,0,0
102537540,3m_after,0,6,0,6,0,0
102537540,3m_before,1,4,0,5,1,0
102537540,60m_before,13,148,0,161,13,0
102537553,3m_after,0,12,0,12,0,0
102537553,3m_before,0,11,0,11,0,0
102537553,60m_before,3,212,0,215,3,0
102537566,3m_after,0,11,0,11,0,0
102537566,3m_before,0,12,0,12,0,0
102537566,60m_before,0,232,0,232,0,0
102537609,60m_before,0,18,0,18,0,0
102537683,60m_before,5,168,0,173,4,1
102537934,3m_after,0,12,0,12,0,0
102537934,3m_before,0,11,0,11,0,0
102537934,60m_before,0,231,0,231,0,0
102538044,3m_after,0,11,0,11,0,0
102538044,3m_before,0,11,0,11,0,0
102538044,60m_before,0,224,0,224,0,0
102538082,60m_before,1,61,0,62,0,1
102538093,3m_after,0,12,0,12,0,0
102538093,3m_before,0,11,0,11,0,0
102538093,60m_before,1,225,0,226,1,0
102538182,3m_after,0,12,0,12,0,0
102538182,3m_before,0,12,0,12,0,0
102538182,60m_before,0,236,0,236,0,0
102538334,3m_after,0,12,0,12,0,0
102538334,3m_before,0,11,0,11,0,0
102538334,60m_before,0,226,0,226,0,0
102538428,3m_after,0,11,0,11,0,0
102538428,3m_before,0,12,0,12,0,0
102538428,60m_before,1,227,0,228,1,0
102538514,3m_after,0,11,0,11,0,0
102538514,3m_before,0,12,0,12,0,0
102538514,60m_before,2,227,0,229,0,2
102538540,3m_after,0,11,0,11,0,0
102538540,3m_before,0,11,0,11,0,0
102538540,60m_before,5,158,0,163,5,0
102538553,60m_before,2,41,0,43,2,0
102538669,3m_after,0,11,0,11,0,0
102538669,3m_before,0,12,0,12,0,0
102538669,60m_before,1,213,0,214,1,0
102538753,3m_after,0,12,0,12,0,0
102538753,3m_before,0,10,0,10,0,0
102538753,60m_before,5,158,0,163,5,0
102538833,3m_after,0,11,0,11,0,0
102538833,3m_before,0,12,0,12,0,0
102538833,60m_before,0,219,0,219,0,0
102538960,3m_after,0,10,0,10,0,0
102538960,3m_before,0,11,0,11,0,0
102538960,60m_before,1,230,0,231,0,1
102539038,3m_after,0,10,0,10,0,0
102539038,3m_before,0,11,0,11,0,0
102539038,60m_before,1,230,0,231,0,1
102539092,3m_after,0,11,0,11,0,0
102539092,3m_before,0,11,0,11,0,0
102539092,60m_before,3,212,0,215,3,0
102539310,3m_after,0,11,0,11,0,0
102539310,3m_before,0,11,0,11,0,0
102539310,60m_before,0,220,0,220,0,0
102539398,3m_after,0,10,0,10,0,0
102539398,3m_before,0,10,0,10,0,0
102539398,60m_before,7,186,0,193,7,0
102539659,3m_after,0,12,0,12,0,0
102539659,3m_before,0,12,0,12,0,0
102539659,60m_before,0,237,0,237,0,0
102539958,3m_after,0,7,0,7,0,0
102539958,3m_before,0,12,0,12,0,0
102539958,60m_before,0,162,0,162,0,0
102540051,60m_before,4,137,0,141,4,0
102540074,3m_after,0,12,0,12,0,0
102540074,3m_before,0,11,0,11,0,0
102540074,60m_before,0,231,0,231,0,0
102540277,3m_after,0,12,0,12,0,0
102540277,3m_before,0,6,0,6,0,0
102540277,60m_before,0,169,0,169,0,0
102540354,3m_after,0,12,0,12,0,0
102540354,3m_before,0,12,0,12,0,0
102540354,60m_before,0,222,0,222,0,0
102540522,3m_after,0,20,0,20,0,0
102540522,3m_before,0,12,0,12,0,0
102540522,60m_before,0,227,0,227,0,0
102540634,3m_after,0,12,0,12,0,0
102540634,60m_before,2,20,0,22,2,0
102540662,3m_before,0,0,1,1,0,1
102540662,60m_before,0,116,1,117,0,1
102540724,3m_before,0,1,0,1,0,0
102540724,60m_before,0,134,0,134,0,0
102540914,3m_after,0,11,0,11,0,0
102540914,3m_before,0,10,0,10,0,0
102540914,60m_before,0,223,0,223,0,0
102541072,3m_after,0,5,0,5,0,0
102541072,3m_before,0,5,0,5,0,0
102541072,60m_before,1,83,0,84,1,0
102541074,3m_after,0,12,0,12,0,0
102541074,3m_before,0,12,0,12,0,0
102541074,60m_before,0,232,0,232,0,0
102541197,3m_after,0,11,0,11,0,0
102541197,3m_before,0,11,0,11,0,0
102541197,60m_before,6,192,0,198,6,0
102541273,3m_after,0,11,0,11,0,0
102541273,3m_before,1,8,0,9,1,0
102541273,60m_before,8,168,0,176,8,0
102541365,60m_before,0,99,0,99,0,0
102541495,3m_after,0,12,0,12,0,0
102541495,3m_before,0,11,0,11,0,0
102541495,60m_before,1,220,0,221,1,0
102541510,60m_before,0,56,0,56,0,0
102541688,3m_after,0,11,0,11,0,0
102541688,3m_before,0,11,0,11,0,0
102541688,60m_before,5,100,0,105,5,0
102541903,3m_after,0,11,0,11,0,0
102541903,3m_before,0,9,0,9,0,0
102541903,60m_before,0,194,0,194,0,0
102541979,3m_after,0,12,0,12,0,0
102541979,3m_before,0,12,0,12,0,0
102541979,60m_before,0,190,0,190,0,0
102542031,3m_after,0,10,0,10,0,0
102542031,3m_before,0,11,0,11,0,0
102542031,60m_before,1,224,0,225,1,0
102542337,3m_after,0,11,0,11,0,0
102542337,3m_before,0,12,0,12,0,0
102542337,60m_before,0,234,0,234,0,0
102542435,60m_before,0,122,0,122,0,0
102542459,3m_after,0,12,0,12,0,0
102542459,3m_before,0,12,0,12,0,0
102542459,60m_before,0,232,0,232,0,0
102542590,60m_before,0,331,0,331,0,0
102542669,3m_after,0,11,0,11,0,0
102542669,3m_before,0,12,0,12,0,0
102542669,60m_before,0,232,0,232,0,0
102542793,60m_before,0,89,0,89,0,0
102543028,3m_after,0,8,0,8,0,0
102543028,60m_before,1,1,0,2,1,0
102543358,3m_after,0,10,0,10,0,0
102543358,3m_before,0,12,0,12,0,0
102543358,60m_before,0,232,0,232,0,0
102543440,3m_after,0,12,0,12,0,0
102543440,3m_before,0,11,0,11,0,0
102543440,60m_before,0,221,0,221,0,0
102543538,3m_after,0,11,0,11,0,0
102543538,3m_before,0,12,0,12,0,0
102543538,60m_before,1,228,0,229,1,0
102543864,3m_after,0,22,0,22,0,0
102543864,3m_before,0,22,0,22,0,0
102543864,60m_before,0,289,0,289,0,0
102544441,3m_after,0,12,0,12,0,0
102544441,3m_before,0,1,0,1,0,0
102544441,60m_before,0,84,0,84,0,0
102544712,3m_after,1,3,0,4,1,0
102544712,3m_before,1,9,0,10,1,0
102544712,60m_before,8,129,0,137,7,1
102544730,3m_after,0,12,0,12,0,0
102544730,3m_before,0,12,0,12,0,0
102544730,60m_before,0,232,0,232,0,0
102544869,3m_before,0,4,0,4,0,0
102544869,60m_before,0,81,0,81,0,0
102544883,60m_before,0,1,0,1,0,0
102545153,3m_after,0,12,0,12,0,0
102545153,3m_before,0,11,0,11,0,0
102545153,60m_before,1,223,0,224,0,1
102545205,3m_after,0,11,0,11,0,0
102545205,3m_before,0,10,0,10,0,0
102545205,60m_before,8,185,0,193,8,0
102545225,3m_after,0,11,0,11,0,0
102545225,3m_before,0,12,0,12,0,0
102545225,60m_before,0,233,0,233,0,0
102545234,3m_after,0,11,0,11,0,0
102545234,3m_before,0,11,0,11,0,0
102545234,60m_before,7,187,0,194,7,0
102545390,3m_after,0,11,0,11,0,0
102545390,3m_before,0,11,0,11,0,0
102545390,60m_before,7,188,0,195,7,0
102545438,3m_after,0,11,0,11,0,0
102545438,3m_before,0,12,0,12,0,0
102545438,60m_before,1,209,0,210,1,0
102545523,60m_before,0,71,0,71,0,0
102545575,3m_after,0,11,0,11,0,0
102545575,3m_before,0,12,0,12,0,0
102545575,60m_before,1,138,0,139,1,0
102545587,3m_after,0,12,0,12,0,0
102545587,3m_before,0,12,0,12,0,0
102545587,60m_before,1,228,0,229,0,1
102545645,3m_after,0,11,0,11,0,0
102545645,3m_before,0,12,0,12,0,0
102545645,60m_before,1,212,0,213,1,0
102545901,3m_after,0,12,0,12,0,0
102545901,3m_before,0,12,0,12,0,0
102545901,60m_before,0,164,0,164,0,0
102546285,3m_after,0,11,0,11,0,0
102546285,3m_before,0,11,0,11,0,0
102546285,60m_before,0,220,0,220,0,0
102546576,60m_before,0,61,0,61,0,0
102546627,3m_after,0,11,0,11,0,0
102546627,3m_before,0,11,0,11,0,0
102546627,60m_before,0,220,0,220,0,0
102546728,60m_before,0,39,0,39,0,0
102546971,3m_after,0,11,0,11,0,0
102546971,3m_before,0,12,0,12,0,0
102546971,60m_before,0,82,0,82,0,0
102547161,60m_before,0,64,0,64,0,0
102547375,3m_after,0,11,0,11,0,0
102547375,3m_before,0,12,0,12,0,0
102547375,60m_before,0,228,0,228,0,0
102547423,3m_after,0,11,0,11,0,0
102547423,3m_before,0,1,0,1,0,0
102547423,60m_before,0,17,0,17,0,0
102547509,3m_after,0,12,0,12,0,0
102547509,3m_before,0,11,0,11,0,0
102547509,60m_before,1,222,0,223,1,0
102547544,3m_after,0,11,0,11,0,0
102547544,3m_before,0,8,0,8,0,0
102547544,60m_before,1,223,0,224,1,0
102547956,3m_after,0,11,0,11,0,0
102547956,3m_before,0,12,0,12,0,0
102547956,60m_before,1,224,0,225,1,0
102547962,3m_after,0,10,0,10,0,0
102547962,3m_before,0,11,0,11,0,0
102547962,60m_before,0,220,0,220,0,0
102547992,3m_after,0,11,0,11,0,0
102547992,3m_before,0,12,0,12,0,0
102547992,60m_before,0,227,0,227,0,0
102548150,3m_after,0,1,0,1,0,0
102548150,3m_before,0,6,0,6,0,0
102548150,60m_before,1,72,0,73,1,0
102548175,3m_after,0,12,0,12,0,0
102548175,3m_before,0,10,0,10,0,0
102548175,60m_before,0,26,0,26,0,0
102548245,3m_after,0,12,0,12,0,0
102548245,3m_before,0,11,0,11,0,0
102548245,60m_before,0,221,0,221,0,0
102548889,3m_after,0,12,0,12,0,0
102548889,3m_before,0,11,0,11,0,0
102548889,60m_before,1,225,0,226,1,0
102548926,3m_after,0,12,0,12,0,0
102548926,3m_before,0,11,0,11,0,0
102548926,60m_before,0,233,0,233,0,0
102549115,3m_after,0,12,0,12,0,0
102549115,3m_before,0,12,0,12,0,0
102549115,60m_before,0,234,0,234,0,0
102549137,3m_before,0,6,0,6,0,0
102549137,60m_before,1,56,0,57,1,0
102549339,60m_before,2,33,0,35,0,2
102549522,3m_after,0,12,0,12,0,0
102549522,3m_before,0,9,0,9,0,0
102549522,60m_before,1,82,0,83,1,0
102549614,3m_before,1,0,0,1,0,1
102549614,60m_before,2,86,0,88,1,1
102549672,3m_after,0,12,0,12,0,0
102549672,3m_before,0,9,0,9,0,0
102549672,60m_before,1,85,0,86,1,0
102549723,3m_after,0,12,0,12,0,0
102549723,3m_before,0,11,0,11,0,0
102549723,60m_before,0,174,0,174,0,0
102550000,3m_after,0,12,0,12,0,0
102550000,3m_before,0,11,0,11,0,0
102550000,60m_before,1,85,0,86,1,0
102550111,60m_before,2,144,0,146,0,2
102550249,3m_after,0,12,0,12,0,0
102550249,3m_before,0,11,0,11,0,0
102550249,60m_before,0,223,0,223,0,0
102550314,3m_after,0,11,0,11,0,0
102550314,3m_before,0,11,0,11,0,0
102550314,60m_before,0,227,0,227,0,0
102550373,60m_before,0,6,0,6,0,0
102550612,3m_after,0,12,0,12,0,0
102550612,3m_before,0,12,0,12,0,0
102550612,60m_before,0,231,0,231,0,0
102550619,3m_after,0,11,0,11,0,0
102550619,3m_before,0,10,0,10,0,0
102550619,60m_before,3,135,0,138,2,1
102550635,3m_after,0,10,0,10,0,0
102550635,3m_before,0,12,0,12,0,0
102550635,60m_before,1,222,0,223,0,1
102550797,3m_after,0,11,0,11,0,0
102550797,3m_before,0,11,0,11,0,0
102550797,60m_before,0,158,0,158,0,0
102550837,3m_after,0,12,0,12,0,0
102550837,3m_before,0,11,0,11,0,0
102550837,60m_before,0,230,0,230,0,0
102551194,3m_after,0,11,0,11,0,0
102551194,3m_before,0,11,0,11,0,0
102551194,60m_before,0,213,0,213,0,0
102551214,3m_after,0,11,0,11,0,0
102551214,3m_before,0,12,0,12,0,0
102551214,60m_before,0,231,0,231,0,0
102551287,3m_after,0,11,0,11,0,0
102551287,3m_before,0,11,0,11,0,0
102551287,60m_before,0,228,0,228,0,0
102552381,3m_after,0,11,0,11,0,0
102552381,3m_before,0,8,0,8,0,0
102552381,60m_before,1,103,0,104,0,1
102552703,3m_after,0,9,0,9,0,0
102552703,3m_before,0,12,0,12,0,0
102552703,60m_before,0,219,0,219,0,0
102552810,3m_after,0,11,0,11,0,0
102552810,3m_before,0,11,0,11,0,0
102552810,60m_before,0,200,0,200,0,0
102552846,3m_after,0,11,0,11,0,0
102552846,3m_before,0,12,0,12,0,0
102552846,60m_before,0,125,0,125,0,0
102552851,3m_after,0,23,0,23,0,0
102552851,3m_before,0,22,0,22,0,0
102552851,60m_before,0,448,0,448,0,0
102552909,3m_after,0,11,0,11,0,0
102552909,3m_before,0,12,0,12,0,0
102552909,60m_before,0,231,0,231,0,0
102553415,3m_after,0,11,0,11,0,0
102553415,3m_before,0,12,0,12,0,0
102553415,60m_before,0,230,0,230,0,0
102553832,3m_after,0,12,0,12,0,0
102553832,3m_before,0,11,0,11,0,0
102553832,60m_before,0,230,0,230,0,0
102553947,60m_before,0,30,0,30,0,0
102553983,3m_after,0,11,0,11,0,0
102553983,3m_before,0,11,0,11,0,0
102553983,60m_before,0,199,0,199,0,0
102554122,3m_after,0,12,0,12,0,0
102554122,3m_before,0,6,0,6,0,0
102554122,60m_before,0,136,0,136,0,0
102554680,60m_before,1,82,0,83,1,0
102554858,3m_after,0,11,0,11,0,0
102554858,3m_before,0,12,0,12,0,0
102554858,60m_before,0,231,0,231,0,0
102555179,3m_after,0,11,0,11,0,0
102555179,3m_before,0,12,0,12,0,0
102555179,60m_before,0,229,0,229,0,0
102555458,3m_after,0,12,0,12,0,0
102555458,3m_before,0,11,0,11,0,0
102555458,60m_before,0,233,0,233,0,0
102555822,60m_before,1,25,0,26,1,0
102555874,3m_after,0,11,0,11,0,0
102555874,3m_before,0,11,0,11,0,0
102555874,60m_before,0,217,0,217,0,0
102556088,3m_after,0,11,0,11,0,0
102556088,3m_before,0,12,0,12,0,0
102556088,60m_before,0,231,0,231,0,0
102556244,3m_after,1,7,0,8,1,0
102556244,3m_before,0,9,0,9,0,0
102556244,60m_before,10,139,0,149,10,0
102556278,3m_after,0,12,0,12,0,0
102556278,3m_before,0,11,0,11,0,0
102556278,60m_before,0,233,0,233,0,0
102556728,3m_after,0,5,0,5,0,0
102556728,60m_before,0,5,0,5,0,0
102556829,3m_after,0,11,0,11,0,0
102556829,3m_before,0,12,0,12,0,0
102556829,60m_before,0,88,0,88,0,0
102556896,3m_after,0,2,0,2,0,0
102556896,3m_before,0,9,0,9,0,0
102556896,60m_before,0,226,0,226,0,0
102557106,60m_before,0,177,0,177,0,0
102557178,60m_before,0,174,0,174,0,0
102557189,3m_after,0,12,0,12,0,0
102557189,3m_before,0,12,0,12,0,0
102557189,60m_before,1,221,0,222,1,0
102557271,60m_before,0,173,0,173,0,0
102557401,3m_after,0,12,0,12,0,0
102557401,3m_before,0,11,0,11,0,0
102557401,60m_before,0,230,0,230,0,0
102557416,3m_after,0,12,0,12,0,0
102557416,3m_before,0,12,0,12,0,0
102557416,60m_before,0,236,0,236,0,0
102557488,3m_after,0,11,0,11,0,0
102557488,3m_before,0,12,0,12,0,0
102557488,60m_before,0,234,0,234,0,0
102557507,3m_after,0,11,0,11,0,0
102557507,3m_before,0,11,0,11,0,0
102557507,60m_before,0,218,0,218,0,0
102558011,3m_after,0,11,0,11,0,0
102558011,3m_before,1,6,0,7,1,0
102558011,60m_before,3,216,0,219,3,0
102558065,3m_after,0,12,0,12,0,0
102558065,3m_before,0,11,0,11,0,0
102558065,60m_before,0,213,0,213,0,0
102558145,60m_before,0,11,0,11,0,0
102558310,3m_before,1,1,0,2,1,0
102558310,60m_before,2,83,0,85,2,0
102558587,3m_after,0,11,0,11,0,0
102558587,3m_before,0,11,0,11,0,0
102558587,60m_before,0,219,0,219,0,0
102558996,3m_after,0,11,0,11,0,0
102558996,3m_before,0,12,0,12,0,0
102558996,60m_before,3,209,0,212,3,0
102559096,60m_before,0,80,0,80,0,0
102559111,3m_after,0,12,0,12,0,0
102559111,3m_before,0,11,0,11,0,0
102559111,60m_before,2,211,0,213,2,0
102559296,3m_after,0,12,0,12,0,0
102559296,3m_before,0,11,0,11,0,0
102559296,60m_before,0,232,0,232,0,0
102559379,3m_after,0,12,0,12,0,0
102559379,3m_before,0,12,0,12,0,0
102559379,60m_before,4,169,0,173,4,0
102559434,3m_after,0,11,0,11,0,0
102559434,3m_before,0,23,0,23,0,0
102559434,60m_before,1,197,0,198,1,0
102559592,3m_after,0,12,0,12,0,0
102559592,3m_before,0,12,0,12,0,0
102559592,60m_before,0,232,0,232,0,0
102559800,3m_after,0,11,0,11,0,0
102559800,3m_before,0,12,0,12,0,0
102559800,60m_before,0,219,0,219,0,0
102559921,3m_after,0,10,0,10,0,0
102559921,3m_before,0,11,0,11,0,0
102559921,60m_before,1,205,0,206,1,0
102560034,3m_after,0,11,0,11,0,0
102560034,3m_before,0,11,0,11,0,0
102560034,60m_before,1,203,0,204,1,0
102560337,3m_after,0,11,0,11,0,0
102560337,3m_before,0,12,0,12,0,0
102560337,60m_before,1,229,0,230,1,0
102560567,3m_after,0,11,0,11,0,0
102560567,3m_before,0,10,0,10,0,0
102560567,60m_before,0,211,0,211,0,0
102560589,3m_after,0,11,0,11,0,0
102560589,3m_before,0,11,0,11,0,0
102560589,60m_before,0,215,0,215,0,0
102560689,3m_after,0,11,0,11,0,0
102560689,3m_before,0,12,0,12,0,0
102560689,60m_before,0,143,0,143,0,0
102560719,60m_before,0,112,0,112,0,0
102560756,60m_before,0,57,0,57,0,0
102561016,3m_after,0,12,0,12,0,0
102561016,3m_before,0,11,0,11,0,0
102561016,60m_before,0,230,0,230,0,0
102561603,60m_before,0,6,0,6,0,0
102561728,3m_after,0,12,0,12,0,0
102561728,3m_before,0,12,0,12,0,0
102561728,60m_before,1,221,0,222,1,0
102561888,3m_after,0,11,0,11,0,0
102561888,3m_before,0,11,0,11,0,0
102561888,60m_before,0,54,0,54,0,0
102561962,3m_after,0,11,0,11,0,0
102561962,3m_before,0,12,0,12,0,0
102561962,60m_before,0,230,0,230,0,0
102562065,3m_after,0,12,0,12,0,0
102562065,3m_before,0,12,0,12,0,0
102562065,60m_before,0,66,0,66,0,0
102562147,3m_after,0,24,0,24,0,0
102562147,3m_before,0,22,0,22,0,0
102562147,60m_before,0,448,0,448,0,0
102562251,3m_after,0,12,0,12,0,0
102562251,3m_before,0,12,0,12,0,0
102562251,60m_before,0,232,0,232,0,0
102562471,3m_after,0,12,0,12,0,0
102562471,3m_before,0,12,0,12,0,0
102562471,60m_before,2,222,0,224,2,0
102562504,3m_after,0,24,0,24,0,0
102562504,3m_before,0,24,0,24,0,0
102562504,60m_before,0,346,0,346,0,0
102562526,3m_after,0,2,0,2,0,0
102562526,3m_before,0,1,0,1,0,0
102562526,60m_before,0,7,0,7,0,0
102562610,3m_after,0,11,0,11,0,0
102562610,3m_before,0,12,0,12,0,0
102562610,60m_before,2,222,0,224,2,0
102562732,3m_after,0,12,0,12,0,0
102562732,3m_before,0,12,0,12,0,0
102562732,60m_before,0,170,0,170,0,0
102562800,3m_after,0,6,0,6,0,0
102562800,3m_before,0,1,0,1,0,0
102562800,60m_before,1,31,0,32,1,0
102563047,3m_after,0,11,0,11,0,0
102563047,3m_before,0,11,0,11,0,0
102563047,60m_before,0,219,0,219,0,0
102563099,60m_before,0,66,0,66,0,0
102563112,60m_before,0,35,0,35,0,0
102563194,60m_before,1,68,0,69,1,0
102563321,3m_after,0,11,0,11,0,0
102563321,3m_before,0,11,0,11,0,0
102563321,60m_before,0,230,0,230,0,0
102563345,3m_after,0,9,0,9,0,0
102563345,60m_before,0,20,0,20,0,0
102563384,3m_before,0,7,0,7,0,0
102563384,60m_before,0,21,0,21,0,0
102563575,3m_after,0,9,0,9,0,0
102563575,60m_before,0,20,0,20,0,0
102563632,3m_after,0,11,0,11,0,0
102563632,3m_before,0,11,0,11,0,0
102563632,60m_before,2,205,0,207,2,0
102563845,60m_before,1,14,0,15,0,1
102563855,3m_after,0,11,0,11,0,0
102563855,3m_before,0,12,0,12,0,0
102563855,60m_before,0,99,0,99,0,0
102563858,3m_after,0,10,0,10,0,0
102563858,60m_before,4,142,0,146,2,2
102563867,3m_after,0,9,0,9,0,0
102563867,3m_before,0,3,0,3,0,0
102563867,60m_before,1,72,0,73,0,1
102563874,3m_after,0,11,0,11,0,0
102563874,3m_before,0,12,0,12,0,0
102563874,60m_before,0,233,0,233,0,0
102563901,60m_before,0,38,0,38,0,0
102564598,3m_after,0,12,0,12,0,0
102564598,3m_before,0,12,0,12,0,0
102564598,60m_before,0,235,0,235,0,0
102564607,3m_after,0,11,0,11,0,0
102564607,3m_before,0,12,0,12,0,0
102564607,60m_before,2,218,0,220,2,0
102564618,3m_after,0,11,0,11,0,0
102564618,3m_before,0,12,0,12,0,0
102564618,60m_before,0,234,0,234,0,0
102564768,3m_after,0,11,0,11,0,0
102564768,3m_before,0,10,0,10,0,0
102564768,60m_before,0,218,0,218,0,0
102564825,3m_after,0,11,0,11,0,0
102564825,3m_before,0,12,0,12,0,0
102564825,60m_before,0,234,0,234,0,0
102565014,60m_before,0,117,0,117,0,0
102565059,3m_after,0,12,0,12,0,0
102565059,3m_before,1,10,0,11,0,1
102565059,60m_before,2,68,0,70,0,2
102565322,3m_after,0,12,0,12,0,0
102565322,3m_before,0,11,0,11,0,0
102565322,60m_before,2,214,0,216,2,0
102565346,3m_after,1,9,0,10,1,0
102565346,3m_before,0,12,0,12,0,0
102565346,60m_before,0,234,0,234,0,0
102565478,3m_after,0,12,0,12,0,0
102565478,3m_before,0,12,0,12,0,0
102565478,60m_before,0,233,0,233,0,0
102565533,3m_after,0,12,0,12,0,0
102565533,3m_before,0,12,0,12,0,0
102565533,60m_before,0,105,0,105,0,0
102565590,3m_after,0,11,0,11,0,0
102565590,3m_before,0,10,0,10,0,0
102565590,60m_before,2,207,0,209,2,0
102565868,3m_after,0,8,0,8,0,0
102565868,3m_before,0,12,0,12,0,0
102565868,60m_before,0,28,0,28,0,0
102566305,3m_after,0,12,0,12,0,0
102566305,3m_before,0,11,0,11,0,0
102566305,60m_before,0,224,0,224,0,0
102566419,3m_after,0,11,0,11,0,0
102566419,3m_before,0,12,0,12,0,0
102566419,60m_before,2,215,0,217,2,0
102566655,3m_after,0,12,0,12,0,0
102566655,3m_before,0,11,0,11,0,0
102566655,60m_before,0,234,0,234,0,0
102566883,3m_after,0,12,0,12,0,0
102566883,3m_before,0,11,0,11,0,0
102566883,60m_before,4,145,0,149,2,2
102567057,3m_after,0,11,0,11,0,0
102567057,3m_before,0,12,0,12,0,0
102567057,60m_before,4,145,0,149,2,2
102567169,60m_before,0,30,0,30,0,0
102567341,3m_after,0,11,0,11,0,0
102567341,3m_before,0,8,0,8,0,0
102567341,60m_before,0,189,0,189,0,0
102567355,3m_after,0,12,0,12,0,0
102567355,3m_before,0,13,0,13,0,0
102567355,60m_before,0,43,0,43,0,0
102567546,3m_after,0,11,0,11,0,0
102567546,3m_before,0,12,0,12,0,0
102567546,60m_before,0,152,0,152,0,0
102567753,3m_after,0,11,0,11,0,0
102567753,3m_before,0,2,0,2,0,0
102567753,60m_before,0,100,0,100,0,0
102567915,3m_after,0,12,0,12,0,0
102567915,3m_before,0,11,0,11,0,0
102567915,60m_before,0,221,0,221,0,0
102568084,3m_after,0,11,0,11,0,0
102568084,3m_before,0,12,0,12,0,0
102568084,60m_before,0,233,0,233,0,0
102568364,3m_after,1,7,0,8,1,0
102568364,3m_before,0,3,0,3,0,0
102568364,60m_before,0,201,0,201,0,0
102568470,3m_after,0,11,0,11,0,0
102568470,3m_before,0,11,0,11,0,0
102568470,60m_before,0,223,0,223,0,0
102568592,3m_after,0,12,0,12,0,0
102568592,3m_before,0,12,0,12,0,0
102568592,60m_before,1,78,0,79,0,1
102568807,60m_before,8,34,0,42,8,0
102569276,3m_after,0,1,0,1,0,0
102569276,3m_before,0,7,0,7,0,0
102569276,60m_before,1,57,0,58,1,0
102569360,3m_after,0,11,0,11,0,0
102569360,3m_before,0,11,0,11,0,0
102569360,60m_before,1,220,0,221,1,0
102570051,60m_before,0,14,0,14,0,0
102570073,3m_after,0,11,0,11,0,0
102570073,3m_before,0,11,0,11,0,0
102570073,60m_before,0,228,0,228,0,0
102570793,60m_before,0,6,0,6,0,0
102570928,3m_after,0,12,0,12,0,0
102570928,3m_before,0,12,0,12,0,0
102570928,60m_before,1,226,0,227,1,0
102570975,3m_after,0,12,0,12,0,0
102570975,3m_before,0,12,0,12,0,0
102570975,60m_before,0,234,0,234,0,0
102571159,3m_after,0,11,0,11,0,0
102571159,3m_before,0,11,0,11,0,0
102571159,60m_before,2,203,0,205,2,0
102571259,3m_after,0,10,0,10,0,0
102571259,3m_before,0,10,0,10,0,0
102571259,60m_before,0,208,0,208,0,0
102571361,3m_after,0,11,0,11,0,0
102571361,3m_before,0,12,0,12,0,0
102571361,60m_before,0,230,0,230,0,0
102571659,3m_after,0,11,0,11,0,0
102571659,3m_before,0,12,0,12,0,0
102571659,60m_before,0,203,0,203,0,0
102571685,3m_after,1,0,0,1,0,1
102571685,3m_before,0,2,0,2,0,0
102571685,60m_before,0,217,0,217,0,0
102571700,60m_before,0,2,0,2,0,0
102571928,3m_after,0,11,0,11,0,0
102571928,3m_before,0,12,0,12,0,0
102571928,60m_before,0,234,0,234,0,0
102572468,60m_before,0,208,0,208,0,0
102572652,3m_before,0,5,0,5,0,0
102572652,60m_before,0,69,0,69,0,0
102572675,3m_after,0,3,0,3,0,0
102572675,60m_before,0,28,0,28,0,0
102573201,3m_after,0,11,0,11,0,0
102573201,3m_before,0,11,0,11,0,0
102573201,60m_before,0,113,0,113,0,0
102573464,3m_before,0,4,1,5,0,1
102573464,60m_before,0,14,1,15,0,1
102573607,60m_before,0,191,0,191,0,0
102573615,3m_after,0,11,0,11,0,0
102573615,3m_before,0,12,0,12,0,0
102573615,60m_before,0,71,0,71,0,0
102573687,3m_after,0,12,0,12,0,0
102573687,3m_before,0,10,0,10,0,0
102573687,60m_before,0,49,0,49,0,0
102573751,3m_after,0,12,0,12,0,0
102573751,3m_before,0,10,0,10,0,0
102573751,60m_before,2,210,0,212,1,1
102574269,3m_after,0,10,0,10,0,0
102574269,3m_before,0,11,0,11,0,0
102574269,60m_before,0,124,0,124,0,0
102574706,3m_after,0,11,0,11,0,0
102574706,3m_before,0,12,0,12,0,0
102574706,60m_before,0,228,0,228,0,0
102574779,3m_after,0,12,0,12,0,0
102574779,3m_before,0,11,0,11,0,0
102574779,60m_before,1,162,0,163,0,1
102574851,3m_after,0,4,0,4,0,0
102574851,3m_before,0,2,0,2,0,0
102574851,60m_before,1,7,0,8,1,0
102575096,3m_after,0,9,0,9,0,0
102575212,3m_after,0,11,0,11,0,0
102575212,3m_before,0,12,0,12,0,0
102575212,60m_before,0,233,0,233,0,0
102575293,3m_after,0,24,0,24,0,0
102575293,60m_before,0,167,0,167,0,0
102575772,3m_after,0,11,0,11,0,0
102575772,3m_before,0,11,0,11,0,0
102575772,60m_before,0,82,0,82,0,0
102575810,3m_after,0,8,0,8,0,0
102575810,3m_before,0,10,0,10,0,0
102575810,60m_before,5,195,0,200,5,0
102575907,3m_after,0,12,0,12,0,0
102575907,3m_before,0,11,0,11,0,0
102575907,60m_before,0,230,0,230,0,0
102576074,3m_after,0,11,0,11,0,0
102576074,3m_before,0,11,0,11,0,0
102576074,60m_before,0,218,0,218,0,0
102576352,3m_after,0,5,0,5,0,0
102576352,3m_before,0,2,0,2,0,0
102576352,60m_before,0,63,0,63,0,0
102576387,3m_after,0,12,0,12,0,0
102576387,3m_before,0,11,0,11,0,0
102576387,60m_before,0,232,0,232,0,0
102576514,3m_before,0,1,0,1,0,0
102576514,60m_before,0,19,0,19,0,0
102576624,3m_after,0,11,0,11,0,0
102576624,3m_before,0,11,0,11,0,0
102576624,60m_before,1,188,0,189,0,1
102576777,3m_after,0,12,0,12,0,0
102576777,3m_before,0,11,0,11,0,0
102576777,60m_before,1,232,0,233,1,0
102576955,3m_after,0,3,0,3,0,0
102576955,3m_before,0,6,0,6,0,0
102576955,60m_before,5,192,0,197,5,0
102577098,3m_after,0,12,0,12,0,0
102577098,3m_before,0,11,0,11,0,0
102577098,60m_before,0,190,0,190,0,0
102577209,3m_after,0,4,0,4,0,0
102577209,3m_before,0,3,0,3,0,0
102577209,60m_before,0,68,0,68,0,0
102577362,3m_after,0,11,0,11,0,0
102577362,3m_before,0,11,0,11,0,0
102577362,60m_before,5,196,0,201,5,0
102577375,3m_after,0,11,0,11,0,0
102577375,3m_before,0,11,0,11,0,0
102577375,60m_before,0,231,0,231,0,0
102577471,3m_after,0,9,0,9,0,0
102577471,3m_before,0,3,0,3,0,0
102577471,60m_before,5,185,0,190,5,0
102577813,3m_after,0,12,0,12,0,0
102577813,3m_before,0,11,0,11,0,0
102577813,60m_before,0,227,0,227,0,0
102577994,3m_after,0,11,0,11,0,0
102577994,3m_before,0,12,0,12,0,0
102577994,60m_before,1,232,0,233,1,0
102578071,3m_after,0,12,0,12,0,0
102578071,3m_before,0,11,0,11,0,0
102578071,60m_before,0,225,0,225,0,0
102578233,60m_before,6,82,0,88,5,1
102578255,60m_before,0,6,0,6,0,0
102578292,3m_after,0,12,0,12,0,0
102578292,3m_before,0,11,0,11,0,0
102578292,60m_before,1,220,0,221,0,1
102578490,60m_before,0,86,0,86,0,0
102578748,3m_after,0,11,0,11,0,0
102578748,3m_before,0,11,0,11,0,0
102578748,60m_before,1,211,0,212,0,1
102578832,3m_after,0,11,0,11,0,0
102578832,3m_before,0,11,0,11,0,0
102578832,60m_before,1,212,0,213,0,1
102579377,3m_after,0,11,0,11,0,0
102579377,3m_before,0,12,0,12,0,0
102579377,60m_before,0,137,0,137,0,0
102579430,3m_after,0,12,0,12,0,0
102579430,3m_before,0,12,0,12,0,0
102579430,60m_before,0,236,0,236,0,0
102579468,3m_after,0,11,0,11,0,0
102579468,3m_before,0,12,0,12,0,0
102579468,60m_before,0,232,0,232,0,0
102579556,3m_after,0,10,0,10,0,0
102579556,3m_before,0,12,0,12,0,0
102579556,60m_before,0,229,0,229,0,0
102579564,3m_after,0,12,0,12,0,0
102579564,3m_before,0,12,0,12,0,0
102579564,60m_before,0,152,0,152,0,0
102579637,3m_after,0,12,0,12,0,0
102579637,3m_before,0,12,0,12,0,0
102579637,60m_before,1,232,0,233,1,0
102579736,60m_before,0,121,0,121,0,0
102579840,60m_before,0,4,0,4,0,0
102579873,3m_after,0,12,0,12,0,0
102579873,3m_before,0,11,0,11,0,0
102579873,60m_before,0,233,0,233,0,0
102580122,3m_after,0,12,0,12,0,0
102580122,3m_before,0,12,0,12,0,0
102580122,60m_before,1,232,0,233,1,0
102580255,3m_after,0,12,0,12,0,0
102580255,3m_before,0,11,0,11,0,0
102580255,60m_before,0,232,0,232,0,0
102580561,3m_after,0,2,0,2,0,0
102580561,60m_before,0,5,1,6,0,1
102580686,60m_before,0,59,1,60,0,1
102580747,3m_after,0,12,0,12,0,0
102580747,3m_before,0,11,0,11,0,0
102580747,60m_before,2,210,0,212,2,0
102581102,3m_after,0,12,0,12,0,0
102581102,3m_before,0,11,0,11,0,0
102581102,60m_before,0,229,0,229,0,0
102581271,60m_before,3,163,0,166,3,0
102581577,3m_after,0,11,0,11,0,0
102581577,3m_before,0,12,0,12,0,0
102581577,60m_before,0,226,0,226,0,0
102581682,3m_after,0,12,0,12,0,0
102581682,3m_before,0,11,0,11,0,0
102581682,60m_before,0,233,0,233,0,0
102581787,3m_after,0,7,0,7,0,0
102581789,3m_after,0,11,0,11,0,0
102581789,3m_before,0,11,0,11,0,0
102581789,60m_before,5,199,0,204,5,0
102581959,3m_after,0,12,0,12,0,0
102581959,3m_before,0,12,0,12,0,0
102581959,60m_before,2,144,0,146,2,0
102582069,3m_after,0,12,0,12,0,0
102582069,3m_before,0,12,0,12,0,0
102582069,60m_before,0,233,0,233,0,0
102582215,3m_before,0,1,0,1,0,0
102582215,60m_before,2,124,0,126,2,0
102582570,3m_after,0,12,0,12,0,0
102582570,3m_before,0,11,0,11,0,0
102582570,60m_before,0,230,0,230,0,0
102582615,3m_after,0,10,0,10,0,0
102582615,3m_before,0,12,0,12,0,0
102582615,60m_before,0,233,0,233,0,0
102582686,3m_after,0,12,0,12,0,0
102582686,3m_before,0,12,0,12,0,0
102582686,60m_before,0,231,0,231,0,0
102582919,3m_after,0,9,0,9,0,0
102582919,3m_before,0,12,0,12,0,0
102582919,60m_before,0,236,0,236,0,0
102582972,3m_after,0,12,0,12,0,0
102582972,3m_before,0,11,0,11,0,0
102582972,60m_before,0,177,0,177,0,0
102583205,60m_before,0,102,0,102,0,0
102583370,3m_after,0,12,0,12,0,0
102583370,3m_before,0,11,0,11,0,0
102583370,60m_before,0,227,0,227,0,0
102583414,3m_after,0,11,0,11,0,0
102583414,3m_before,0,12,0,12,0,0
102583414,60m_before,1,227,0,228,1,0
102584120,3m_after,0,11,0,11,0,0
102584120,3m_before,0,11,0,11,0,0
102584120,60m_before,0,217,0,217,0,0
102584391,3m_after,0,11,0,11,0,0
102584391,3m_before,0,11,0,11,0,0
102584391,60m_before,0,217,0,217,0,0
102584509,3m_after,0,12,0,12,0,0
102584509,3m_before,0,12,0,12,0,0
102584509,60m_before,0,235,0,235,0,0
102584707,3m_after,0,8,0,8,0,0
102584707,3m_before,0,3,0,3,0,0
102584707,60m_before,0,130,0,130,0,0
102584721,3m_after,0,12,0,12,0,0
102584721,3m_before,0,4,0,4,0,0
102584721,60m_before,0,217,0,217,0,0
102584737,60m_before,1,6,0,7,0,1
102584807,3m_after,0,15,0,15,0,0
102584807,3m_before,0,1,0,1,0,0
102584807,60m_before,0,191,0,191,0,0
102584816,60m_before,0,14,0,14,0,0
102584882,3m_after,0,12,0,12,0,0
102584882,3m_before,0,12,0,12,0,0
102584882,60m_before,0,235,0,235,0,0
102584904,3m_after,0,12,0,12,0,0
102584904,3m_before,0,12,0,12,0,0
102584904,60m_before,0,235,0,235,0,0
102585501,3m_after,1,4,0,5,0,1
102585501,3m_before,0,12,0,12,0,0
102585501,60m_before,0,229,0,229,0,0
102585763,3m_after,0,11,0,11,0,0
102585763,3m_before,0,11,0,11,0,0
102585763,60m_before,0,217,0,217,0,0
102586005,3m_after,0,12,0,12,0,0
102586005,3m_before,0,11,0,11,0,0
102586005,60m_before,0,232,0,232,0,0
102586251,3m_after,0,12,0,12,0,0
102586251,3m_before,0,11,0,11,0,0
102586251,60m_before,0,86,0,86,0,0
102586326,60m_before,0,21,0,21,0,0
102586423,3m_after,0,9,0,9,0,0
102586423,3m_before,0,10,0,10,0,0
102586423,60m_before,5,44,0,49,5,0
102586444,3m_after,0,11,0,11,0,0
102586444,3m_before,0,11,0,11,0,0
102586444,60m_before,0,222,0,222,0,0
102586697,3m_after,0,18,0,18,0,0
102586697,3m_before,0,12,0,12,0,0
102586697,60m_before,0,229,0,229,0,0
102586716,3m_after,0,11,0,11,0,0
102586716,3m_before,0,11,0,11,0,0
102586716,60m_before,0,217,0,217,0,0
102586906,3m_after,0,11,0,11,0,0
102586906,3m_before,0,12,0,12,0,0
102586906,60m_before,0,127,0,127,0,0
102586938,3m_after,0,11,0,11,0,0
102586938,3m_before,0,12,0,12,0,0
102586938,60m_before,0,233,0,233,0,0
102587013,3m_after,0,11,0,11,0,0
102587013,3m_before,0,12,0,12,0,0
102587013,60m_before,0,127,0,127,0,0
102587403,3m_after,0,11,0,11,0,0
102587403,3m_before,0,11,0,11,0,0
102587403,60m_before,1,82,0,83,1,0
102587548,3m_after,0,11,0,11,0,0
102587548,3m_before,0,11,0,11,0,0
102587548,60m_before,0,219,0,219,0,0
102587589,3m_after,0,12,0,12,0,0
102587589,3m_before,0,11,0,11,0,0
102587589,60m_before,0,232,0,232,0,0
102587632,60m_before,0,38,1,39,0,1
102587883,60m_before,0,29,1,30,0,1
102587922,3m_after,0,11,0,11,0,0
102587922,3m_before,0,10,0,10,0,0
102587922,60m_before,0,224,0,224,0,0
102588000,3m_after,0,7,0,7,0,0
102588000,60m_before,0,129,0,129,0,0
102588051,3m_after,0,11,0,11,0,0
102588051,3m_before,0,11,0,11,0,0
102588051,60m_before,1,221,0,222,0,1
102588147,3m_after,0,11,0,11,0,0
102588147,3m_before,0,12,0,12,0,0
102588147,60m_before,2,217,0,219,0,2
102588276,3m_after,0,12,0,12,0,0
102588276,3m_before,0,11,0,11,0,0
102588276,60m_before,0,222,0,222,0,0
102588288,3m_after,0,23,0,23,0,0
102588288,3m_before,0,24,0,24,0,0
102588288,60m_before,2,445,0,447,2,0
102588310,3m_after,0,11,0,11,0,0
102588310,3m_before,0,12,0,12,0,0
102588310,60m_before,0,231,0,231,0,0
102588325,3m_after,0,11,0,11,0,0
102588325,3m_before,0,10,0,10,0,0
102588325,60m_before,1,82,0,83,1,0
102588340,3m_after,0,12,0,12,0,0
102588340,3m_before,0,12,0,12,0,0
102588340,60m_before,0,233,0,233,0,0
102588463,3m_after,0,20,0,20,0,0
102588463,3m_before,0,6,0,6,0,0
102588463,60m_before,0,181,0,181,0,0
102588494,60m_before,1,19,0,20,1,0
102588624,3m_after,0,11,0,11,0,0
102588624,3m_before,0,10,0,10,0,0
102588624,60m_before,1,82,0,83,1,0
102588647,3m_before,0,4,0,4,0,0
102588647,60m_before,0,25,0,25,0,0
102588671,3m_after,0,1,0,1,0,0
102588671,60m_before,0,7,0,7,0,0
102588734,3m_after,0,22,0,22,0,0
102588734,3m_before,0,10,0,10,0,0
102588734,60m_before,0,181,0,181,0,0
102588799,3m_after,0,12,0,12,0,0
102588799,3m_before,0,12,0,12,0,0
102588799,60m_before,1,129,0,130,1,0
102588848,3m_after,0,10,0,10,0,0
102588848,3m_before,0,11,0,11,0,0
102588848,60m_before,0,219,0,219,0,0
102589214,3m_after,0,11,0,11,0,0
102589214,3m_before,0,11,0,11,0,0
102589214,60m_before,3,209,0,212,3,0
102589445,3m_after,0,12,0,12,0,0
102589445,3m_before,0,11,0,11,0,0
102589445,60m_before,0,221,0,221,0,0
102589575,60m_before,1,6,0,7,0,1
102589641,3m_after,1,0,0,1,1,0
102589641,60m_before,0,29,1,30,0,1
102589643,3m_after,0,1,0,1,0,0
102589643,60m_before,0,30,1,31,0,1
102589758,3m_after,0,12,0,12,0,0
102589758,3m_before,0,12,0,12,0,0
102589758,60m_before,0,233,0,233,0,0
102590109,3m_after,0,11,0,11,0,0
102590109,3m_before,0,10,0,10,0,0
102590109,60m_before,0,13,0,13,0,0
102590198,3m_after,0,10,0,10,0,0
102590198,3m_before,0,12,0,12,0,0
102590198,60m_before,0,218,0,218,0,0
102590269,3m_after,0,11,0,11,0,0
102590269,3m_before,0,5,0,5,0,0
102590269,60m_before,0,190,0,190,0,0
102590488,3m_after,0,5,0,5,0,0
102590488,3m_before,0,4,0,4,0,0
102590488,60m_before,0,184,0,184,0,0
102590697,3m_after,0,11,0,11,0,0
102590697,3m_before,0,12,0,12,0,0
102590697,60m_before,1,155,0,156,1,0
102590861,60m_before,0,2,0,2,0,0
102590891,3m_after,0,10,0,10,0,0
102590891,3m_before,0,8,0,8,0,0
102590891,60m_before,0,196,0,196,0,0
102591056,3m_after,0,7,0,7,0,0
102591056,3m_before,0,9,0,9,0,0
102591056,60m_before,2,216,0,218,0,2
102591390,3m_after,0,11,0,11,0,0
102591390,3m_before,0,12,0,12,0,0
102591390,60m_before,0,231,0,231,0,0
102591837,3m_after,2,10,0,12,0,2
102591837,3m_before,0,4,0,4,0,0
102591837,60m_before,2,210,0,212,0,2
102591884,3m_after,0,11,0,11,0,0
102591884,3m_before,0,11,0,11,0,0
102591884,60m_before,0,217,0,217,0,0
102591888,3m_after,0,12,0,12,0,0
102591888,3m_before,0,12,0,12,0,0
102591888,60m_before,0,222,0,222,0,0
102592227,3m_after,0,12,0,12,0,0
102592227,3m_before,0,12,0,12,0,0
102592227,60m_before,0,238,0,238,0,0
102592268,3m_after,0,18,0,18,0,0
102592268,3m_before,0,12,0,12,0,0
102592268,60m_before,0,230,0,230,0,0
102592327,3m_after,0,12,0,12,0,0
102592327,3m_before,0,11,0,11,0,0
102592327,60m_before,0,232,0,232,0,0
102592453,3m_after,0,11,0,11,0,0
102592453,3m_before,0,3,0,3,0,0
102592453,60m_before,1,28,1,30,1,1
102592594,3m_after,0,24,0,24,0,0
102592594,3m_before,0,11,0,11,0,0
102592594,60m_before,0,229,0,229,0,0
102592636,3m_after,0,12,0,12,0,0
102592636,3m_before,0,12,0,12,0,0
102592636,60m_before,0,236,0,236,0,0
102592669,3m_after,0,4,0,4,0,0
102592669,3m_before,0,12,0,12,0,0
102592669,60m_before,0,228,0,228,0,0
102592747,3m_after,0,2,0,2,0,0
102592747,3m_before,0,12,0,12,0,0
102592747,60m_before,0,227,0,227,0,0
102592758,3m_after,0,11,0,11,0,0
102592758,3m_before,0,9,0,9,0,0
102592758,60m_before,1,213,0,214,1,0
102592782,3m_after,0,11,0,11,0,0
102592782,3m_before,0,12,0,12,0,0
102592782,60m_before,0,235,0,235,0,0
102592901,60m_before,0,22,0,22,0,0
102593162,60m_before,0,19,0,19,0,0
102593187,3m_after,0,12,0,12,0,0
102593187,3m_before,0,11,0,11,0,0
102593187,60m_before,0,235,0,235,0,0
102593234,3m_after,0,11,0,11,0,0
102593234,3m_before,0,10,0,10,0,0
102593234,60m_before,0,160,0,160,0,0
102593394,3m_after,0,3,0,3,0,0
102593407,60m_before,0,17,0,17,0,0
102593479,3m_after,0,12,0,12,0,0
102593479,3m_before,0,12,0,12,0,0
102593479,60m_before,0,234,0,234,0,0
102593531,60m_before,0,4,0,4,0,0
102593610,3m_after,0,12,0,12,0,0
102593610,3m_before,0,11,0,11,0,0
102593610,60m_before,0,232,0,232,0,0
102594116,3m_after,0,12,0,12,0,0
102594116,3m_before,0,12,0,12,0,0
102594116,60m_before,0,188,0,188,0,0
102594209,3m_after,0,12,0,12,0,0
102594209,3m_before,0,11,0,11,0,0
102594209,60m_before,0,235,0,235,0,0
102594230,3m_after,0,12,0,12,0,0
102594230,3m_before,0,12,0,12,0,0
102594230,60m_before,0,179,0,179,0,0
102594233,3m_after,0,24,0,24,0,0
102594233,3m_before,2,6,0,8,0,2
102594233,60m_before,4,208,0,212,0,4
102594435,60m_before,0,12,0,12,0,0
102594569,3m_after,0,6,0,6,0,0
102594569,3m_before,0,2,0,2,0,0
102594569,60m_before,0,146,0,146,0,0
102594653,3m_after,0,22,0,22,0,0
102594653,3m_before,0,18,0,18,0,0
102594653,60m_before,4,215,0,219,0,4
102594697,3m_before,0,5,0,5,0,0
102594697,60m_before,0,6,0,6,0,0
102594713,3m_after,0,11,0,11,0,0
102594713,3m_before,0,11,0,11,0,0
102594713,60m_before,1,92,0,93,1,0
102594830,3m_after,0,8,0,8,0,0
102594830,3m_before,0,4,0,4,0,0
102594830,60m_before,0,16,1,17,0,1
102594989,3m_after,0,12,0,12,0,0
102594989,3m_before,0,7,0,7,0,0
102594989,60m_before,0,126,0,126,0,0
102594998,3m_after,0,6,0,6,0,0
102594998,3m_before,0,1,0,1,0,0
102594998,60m_before,0,23,1,24,0,1
102595015,3m_after,0,11,0,11,0,0
102595015,3m_before,0,12,0,12,0,0
102595015,60m_before,0,220,0,220,0,0
102595138,3m_after,0,12,0,12,0,0
102595138,3m_before,0,7,0,7,0,0
102595138,60m_before,0,127,0,127,0,0
102595229,3m_after,0,11,0,11,0,0
102595229,3m_before,0,12,0,12,0,0
102595229,60m_before,0,72,0,72,0,0
102595277,60m_before,0,6,0,6,0,0
102595345,3m_after,0,11,0,11,0,0
102595345,3m_before,0,12,0,12,0,0
102595345,60m_before,0,232,0,232,0,0
102595357,3m_after,0,11,0,11,0,0
102595357,3m_before,0,11,0,11,0,0
102595357,60m_before,0,220,0,220,0,0
102595407,3m_after,0,11,0,11,0,0
102595407,3m_before,0,12,0,12,0,0
102595407,60m_before,0,77,0,77,0,0
102595590,60m_before,0,6,0,6,0,0
102595744,3m_after,0,11,0,11,0,0
102595744,3m_before,0,11,0,11,0,0
102595744,60m_before,0,174,0,174,0,0
102595769,3m_after,1,6,0,7,1,0
102595769,3m_before,0,10,0,10,0,0
102595769,60m_before,3,171,0,174,3,0
102595936,60m_before,0,6,0,6,0,0
102595993,3m_after,0,23,0,23,0,0
102595993,3m_before,0,23,0,23,0,0
102595993,60m_before,4,245,0,249,0,4
102596425,60m_before,0,6,0,6,0,0
102596594,3m_after,0,12,0,12,0,0
102596594,3m_before,0,10,0,10,0,0
102596594,60m_before,0,234,0,234,0,0
102596781,3m_after,0,12,0,12,0,0
102596781,3m_before,0,11,0,11,0,0
102596781,60m_before,0,211,0,211,0,0
102597023,60m_before,0,6,0,6,0,0
102597066,3m_after,0,12,0,12,0,0
102597066,3m_before,0,11,0,11,0,0
102597066,60m_before,0,231,0,231,0,0
102597121,3m_after,0,10,0,10,0,0
102597121,3m_before,0,11,0,11,0,0
102597121,60m_before,0,131,0,131,0,0
102597410,3m_after,2,2,0,4,2,0
102597410,3m_before,1,6,0,7,1,0
102597410,60m_before,4,164,0,168,4,0
102597749,3m_after,0,12,0,12,0,0
102597749,3m_before,0,12,0,12,0,0
102597749,60m_before,0,234,0,234,0,0
102597864,3m_after,0,12,0,12,0,0
102597864,3m_before,0,11,0,11,0,0
102597864,60m_before,0,157,0,157,0,0
102597889,3m_after,0,12,0,12,0,0
102597889,3m_before,0,11,0,11,0,0
102597889,60m_before,0,234,0,234,0,0
102597998,60m_before,0,11,0,11,0,0
102598101,3m_after,0,10,0,10,0,0
102598101,3m_before,0,10,0,10,0,0
102598101,60m_before,0,194,0,194,0,0
102598279,60m_before,0,6,0,6,0,0
102598334,3m_after,0,12,0,12,0,0
102598334,3m_before,0,11,0,11,0,0
102598334,60m_before,0,231,0,231,0,0
102598335,3m_after,0,11,0,11,0,0
102598335,3m_before,0,3,0,3,0,0
102598335,60m_before,0,120,0,120,0,0
102598346,3m_after,0,12,0,12,0,0
102598346,3m_before,0,11,0,11,0,0
102598346,60m_before,0,233,0,233,0,0
102598776,3m_after,0,7,0,7,0,0
102598776,3m_before,0,7,0,7,0,0
102598776,60m_before,0,119,0,119,0,0
102598872,3m_after,0,12,0,12,0,0
102598872,3m_before,0,12,0,12,0,0
102598872,60m_before,0,234,0,234,0,0
102598976,3m_after,0,10,0,10,0,0
102598976,3m_before,0,10,0,10,0,0
102598976,60m_before,2,204,0,206,2,0
102598987,3m_after,0,9,0,9,0,0
102598987,3m_before,0,12,0,12,0,0
102598987,60m_before,0,222,0,222,0,0
102599000,60m_before,0,48,0,48,0,0
102599220,3m_after,0,11,0,11,0,0
102599220,3m_before,0,12,0,12,0,0
102599220,60m_before,1,210,0,211,0,1
102599305,3m_after,0,10,0,10,0,0
102599305,3m_before,0,11,0,11,0,0
102599305,60m_before,0,194,0,194,0,0
102599325,3m_after,0,12,0,12,0,0
102599325,3m_before,0,11,0,11,0,0
102599325,60m_before,0,235,0,235,0,0
102599331,3m_after,0,22,0,22,0,0
102599331,3m_before,0,24,0,24,0,0
102599331,60m_before,0,400,0,400,0,0
102599340,3m_after,0,11,0,11,0,0
102599340,3m_before,0,9,0,9,0,0
102599340,60m_before,0,229,0,229,0,0
102599357,3m_after,0,12,0,12,0,0
102599357,3m_before,0,11,0,11,0,0
102599357,60m_before,0,233,0,233,0,0
102599479,3m_after,0,11,0,11,0,0
102599479,3m_before,0,11,0,11,0,0
102599479,60m_before,0,232,0,232,0,0
102599507,60m_before,0,11,0,11,0,0
102599519,3m_before,0,1,0,1,0,0
102599519,60m_before,1,122,0,123,1,0
102599742,3m_after,0,12,0,12,0,0
102599742,3m_before,0,12,0,12,0,0
102599742,60m_before,0,234,0,234,0,0
102599852,3m_after,0,12,0,12,0,0
102599852,3m_before,0,11,0,11,0,0
102599852,60m_before,0,233,0,233,0,0
102599969,3m_after,0,12,0,12,0,0
102599969,3m_before,0,11,0,11,0,0
102599969,60m_before,0,234,0,234,0,0
102599990,3m_after,3,7,0,10,3,0
102599990,60m_before,9,141,0,150,9,0
102600112,60m_before,0,6,0,6,0,0
102600321,3m_after,0,10,0,10,0,0
102600321,3m_before,0,9,0,9,0,0
102600321,60m_before,0,182,0,182,0,0
102600362,3m_after,0,9,0,9,0,0
102600362,3m_before,0,3,0,3,0,0
102600362,60m_before,0,116,0,116,0,0
102600371,3m_after,0,12,0,12,0,0
102600371,3m_before,0,12,0,12,0,0
102600371,60m_before,0,222,0,222,0,0
102600431,3m_after,1,2,0,3,1,0
102600431,3m_before,0,11,0,11,0,0
102600431,60m_before,0,233,0,233,0,0
102600453,3m_after,0,12,0,12,0,0
102600453,3m_before,0,11,0,11,0,0
102600453,60m_before,0,234,0,234,0,0
102600574,3m_after,0,11,0,11,0,0
102600574,3m_before,0,12,0,12,0,0
102600574,60m_before,4,196,0,200,3,1
102600835,60m_before,1,121,0,122,1,0
102600857,60m_before,0,6,0,6,0,0
102601003,3m_after,0,12,0,12,0,0
102601003,3m_before,0,11,0,11,0,0
102601003,60m_before,0,274,0,274,0,0
102601160,3m_before,0,1,0,1,0,0
102601160,60m_before,1,6,0,7,0,1
102601570,3m_after,0,12,0,12,0,0
102601570,3m_before,0,11,0,11,0,0
102601570,60m_before,0,128,0,128,0,0
102601588,3m_after,0,11,0,11,0,0
102601588,3m_before,0,8,0,8,0,0
102601588,60m_before,0,31,0,31,0,0
102601706,3m_after,0,12,0,12,0,0
102601706,3m_before,0,12,0,12,0,0
102601706,60m_before,0,234,0,234,0,0
102601896,3m_after,0,9,0,9,0,0
102601896,3m_before,0,12,0,12,0,0
102601896,60m_before,0,199,0,199,0,0
102601901,3m_after,0,12,0,12,0,0
102601901,3m_before,0,9,0,9,0,0
102601901,60m_before,0,185,0,185,0,0
102602020,3m_after,0,11,0,11,0,0
102602020,3m_before,0,12,0,12,0,0
102602020,60m_before,0,275,0,275,0,0
102602196,3m_after,0,12,0,12,0,0
102602196,3m_before,0,12,0,12,0,0
102602196,60m_before,0,169,0,169,0,0
102602267,3m_after,0,15,0,15,0,0
102602267,3m_before,0,11,0,11,0,0
102602267,60m_before,0,215,0,215,0,0
102602502,3m_after,0,24,0,24,0,0
102602502,3m_before,0,24,0,24,0,0
102602502,60m_before,1,400,2,403,1,2
102602565,3m_after,0,11,0,11,0,0
102602565,3m_before,0,11,0,11,0,0
102602565,60m_before,1,214,0,215,0,1
102602749,3m_after,0,10,0,10,0,0
102602749,3m_before,0,12,0,12,0,0
102602749,60m_before,0,234,0,234,0,0
102602825,3m_after,0,17,0,17,0,0
102602825,60m_before,1,98,0,99,1,0
102602883,3m_after,0,14,0,14,0,0
102602883,3m_before,1,11,0,12,1,0
102602883,60m_before,2,208,0,210,2,0
102602920,3m_before,0,1,0,1,0,0
102602920,60m_before,1,40,0,41,1,0
102602953,60m_before,0,1,0,1,0,0
102603025,3m_before,2,5,0,7,2,0
102603025,60m_before,13,131,0,144,13,0
102603080,3m_after,0,11,0,11,0,0
102603080,3m_before,0,12,0,12,0,0
102603080,60m_before,0,233,0,233,0,0
102603170,60m_before,0,130,0,130,0,0
102603251,3m_after,0,11,0,11,0,0
102603251,3m_before,0,12,0,12,0,0
102603251,60m_before,0,276,0,276,0,0
102603338,3m_before,0,2,0,2,0,0
102603338,60m_before,0,213,0,213,0,0
102603346,3m_before,0,6,0,6,0,0
102603346,60m_before,0,12,0,12,0,0
102603390,3m_after,0,11,0,11,0,0
102603390,3m_before,0,10,0,10,0,0
102603390,60m_before,0,216,0,216,0,0
102603464,3m_after,0,12,0,12,0,0
102603464,3m_before,0,11,0,11,0,0
102603464,60m_before,0,164,0,164,0,0
102603465,3m_after,0,12,0,12,0,0
102603465,3m_before,0,11,0,11,0,0
102603465,60m_before,0,233,0,233,0,0
102603678,3m_after,0,16,0,16,0,0
102603678,3m_before,0,9,0,9,0,0
102603678,60m_before,0,202,0,202,0,0
102603680,3m_after,0,11,0,11,0,0
102603680,3m_before,0,12,0,12,0,0
102603680,60m_before,10,133,0,143,10,0
102603745,60m_before,0,45,0,45,0,0
102603773,3m_after,0,7,0,7,0,0
102603773,3m_before,0,8,0,8,0,0
102603773,60m_before,0,51,0,51,0,0
102603923,3m_after,0,9,0,9,0,0
102603946,60m_before,0,12,0,12,0,0
102603996,60m_before,0,11,0,11,0,0
102604022,60m_before,1,1,0,2,1,0
102604199,3m_after,0,12,0,12,0,0
102604199,3m_before,0,12,0,12,0,0
102604199,60m_before,0,235,0,235,0,0
102604338,60m_before,0,10,0,10,0,0
102604442,60m_before,0,11,0,11,0,0
102604445,3m_after,0,11,0,11,0,0
102604445,3m_before,0,12,0,12,0,0
102604445,60m_before,0,222,0,222,0,0
102604486,60m_before,12,125,0,137,12,0
102604542,3m_after,0,10,0,10,0,0
102604542,3m_before,0,2,0,2,0,0
102604542,60m_before,0,215,0,215,0,0
102604681,3m_after,0,12,0,12,0,0
102604681,3m_before,0,12,0,12,0,0
102604681,60m_before,0,276,0,276,0,0
102604737,3m_after,0,12,0,12,0,0
102604737,3m_before,0,12,0,12,0,0
102604737,60m_before,0,47,0,47,0,0
102604978,3m_after,0,12,0,12,0,0
102604978,3m_before,0,10,0,10,0,0
102604978,60m_before,0,215,0,215,0,0
102605020,3m_after,0,3,0,3,0,0
102605020,3m_before,0,3,0,3,0,0
102605020,60m_before,0,44,0,44,0,0
102605152,3m_before,0,2,0,2,0,0
102605152,60m_before,0,61,0,61,0,0
102605222,3m_after,0,11,0,11,0,0
102605222,3m_before,0,12,0,12,0,0
102605222,60m_before,0,233,0,233,0,0
102605266,3m_after,0,4,0,4,0,0
102605266,3m_before,1,7,0,8,1,0
102605266,60m_before,4,101,0,105,4,0
102605339,3m_after,0,7,0,7,0,0
102605339,3m_before,0,2,0,2,0,0
102605339,60m_before,0,104,0,104,0,0
102605445,3m_after,0,9,0,9,0,0
102605445,3m_before,1,1,0,2,1,0
102605445,60m_before,3,187,0,190,2,1
102605531,3m_after,0,10,0,10,0,0
102605531,3m_before,0,1,0,1,0,0
102605531,60m_before,0,40,0,40,0,0
102605649,3m_after,0,9,0,9,0,0
102605649,3m_before,0,4,0,4,0,0
102605649,60m_before,0,49,0,49,0,0
102605658,60m_before,0,11,0,11,0,0
102605676,60m_before,0,12,0,12,0,0
102605689,3m_after,1,8,0,9,1,0
102605689,3m_before,0,12,0,12,0,0
102605689,60m_before,0,147,0,147,0,0
102605798,3m_after,0,11,0,11,0,0
102605798,3m_before,0,12,0,12,0,0
102605798,60m_before,0,233,0,233,0,0
102605833,60m_before,0,180,0,180,0,0
102605840,3m_after,0,11,0,11,0,0
102605840,3m_before,0,11,0,11,0,0
102605840,60m_before,0,216,0,216,0,0
102605856,3m_after,0,20,0,20,0,0
102605856,3m_before,0,14,0,14,0,0
102605856,60m_before,0,454,0,454,0,0
102605957,3m_after,0,11,0,11,0,0
102605957,3m_before,0,3,0,3,0,0
102605957,60m_before,0,46,0,46,0,0
102606016,3m_after,0,24,0,24,0,0
102606016,3m_before,0,24,0,24,0,0
102606016,60m_before,0,458,0,458,0,0
102606038,3m_after,0,1,0,1,0,0
102606038,60m_before,0,7,0,7,0,0
102606095,3m_after,0,12,0,12,0,0
102606095,3m_before,0,12,0,12,0,0
102606095,60m_before,0,275,0,275,0,0
102606372,3m_after,0,22,0,22,0,0
102606372,3m_before,0,24,0,24,0,0
102606372,60m_before,0,312,0,312,0,0
102606420,3m_after,0,11,0,11,0,0
102606420,3m_before,0,11,0,11,0,0
102606420,60m_before,0,220,0,220,0,0
102606516,3m_after,0,10,0,10,0,0
102606516,3m_before,0,7,0,7,0,0
102606516,60m_before,0,106,0,106,0,0
102606601,3m_after,0,11,0,11,0,0
102606601,3m_before,0,12,0,12,0,0
102606601,60m_before,0,194,0,194,0,0
102606728,3m_after,0,4,0,4,0,0
102606728,60m_before,1,2,0,3,1,0
102606835,60m_before,2,15,0,17,2,0
102606999,60m_before,0,12,0,12,0,0
102607041,3m_after,0,11,0,11,0,0
102607041,3m_before,0,4,0,4,0,0
102607041,60m_before,1,107,0,108,1,0
102607188,3m_after,0,12,0,12,0,0
102607188,3m_before,0,12,0,12,0,0
102607188,60m_before,0,275,0,275,0,0
102607254,3m_after,0,10,0,10,0,0
102607254,3m_before,0,7,0,7,0,0
102607254,60m_before,0,109,0,109,0,0
102607267,3m_after,0,12,0,12,0,0
102607267,3m_before,0,12,0,12,0,0
102607267,60m_before,0,244,0,244,0,0
102607497,3m_after,0,22,0,22,0,0
102607497,3m_before,0,22,0,22,0,0
102607497,60m_before,0,404,0,404,0,0
102607503,60m_before,0,12,0,12,0,0
102607599,3m_after,0,24,0,24,0,0
102607599,3m_before,0,22,0,22,0,0
102607599,60m_before,0,410,0,410,0,0
102607686,3m_after,0,11,0,11,0,0
102607686,3m_before,0,12,0,12,0,0
102607686,60m_before,0,231,0,231,0,0
102607704,3m_after,0,10,0,10,0,0
102607704,3m_before,0,11,0,11,0,0
102607704,60m_before,0,220,0,220,0,0
102607946,3m_after,0,11,0,11,0,0
102607946,3m_before,0,12,0,12,0,0
102607946,60m_before,0,233,0,233,0,0
102608065,60m_before,0,12,0,12,0,0
102608437,3m_after,0,11,0,11,0,0
102608437,3m_before,0,12,0,12,0,0
102608437,60m_before,0,244,0,244,0,0
102608681,60m_before,0,29,0,29,0,0
102608712,3m_after,0,11,0,11,0,0
102608712,3m_before,0,11,0,11,0,0
102608712,60m_before,0,217,0,217,0,0
102608816,3m_after,0,3,0,3,0,0
102608816,3m_before,0,4,0,4,0,0
102608816,60m_before,0,63,0,63,0,0
102608817,60m_before,0,12,0,12,0,0
102608849,3m_after,0,11,0,11,0,0
102608849,3m_before,0,12,0,12,0,0
102608849,60m_before,0,231,0,231,0,0
102608916,3m_after,0,11,0,11,0,0
102608916,3m_before,0,12,0,12,0,0
102608916,60m_before,1,66,0,67,1,0
102608978,3m_after,0,5,0,5,0,0
102609167,3m_after,0,11,0,11,0,0
102609167,3m_before,0,12,0,12,0,0
102609167,60m_before,0,233,0,233,0,0
102609172,60m_before,0,30,0,30,0,0
102609209,3m_after,0,23,0,23,0,0
102609209,3m_before,0,24,0,24,0,0
102609209,60m_before,0,450,0,450,0,0
102609215,3m_after,0,11,0,11,0,0
102609215,3m_before,0,12,0,12,0,0
102609215,60m_before,0,233,0,233,0,0
102609271,3m_after,0,9,0,9,0,0
102609271,3m_before,2,5,0,7,2,0
102609271,60m_before,2,19,0,21,2,0
102609403,3m_after,0,11,0,11,0,0
102609403,3m_before,0,11,0,11,0,0
102609403,60m_before,0,221,0,221,0,0
102609477,3m_after,0,10,0,10,0,0
102609477,3m_before,0,11,0,11,0,0
102609477,60m_before,0,217,0,217,0,0
102609506,3m_after,0,11,0,11,0,0
102609506,3m_before,0,12,0,12,0,0
102609506,60m_before,0,232,0,232,0,0
102609509,3m_after,0,11,0,11,0,0
102609509,3m_before,0,11,0,11,0,0
102609509,60m_before,0,233,0,233,0,0
102609535,3m_after,0,12,0,12,0,0
102609535,3m_before,0,11,0,11,0,0
102609535,60m_before,1,220,0,221,1,0
102609900,3m_after,2,5,0,7,2,0
102609900,3m_before,0,5,0,5,0,0
102609900,60m_before,0,17,0,17,0,0
102609919,3m_after,0,11,0,11,0,0
102609919,3m_before,0,11,0,11,0,0
102609919,60m_before,0,217,0,217,0,0
102609981,3m_after,0,11,0,11,0,0
102609981,3m_before,0,12,0,12,0,0
102609981,60m_before,0,232,0,232,0,0
102610103,3m_after,0,12,0,12,0,0
102610103,3m_before,0,11,0,11,0,0
102610103,60m_before,0,231,0,231,0,0
102610269,3m_after,0,11,0,11,0,0
102610269,3m_before,0,11,0,11,0,0
102610269,60m_before,0,228,0,228,0,0
102610320,3m_after,0,11,0,11,0,0
102610320,3m_before,0,12,0,12,0,0
102610320,60m_before,0,233,0,233,0,0
102610507,3m_after,0,11,0,11,0,0
102610507,3m_before,0,12,0,12,0,0
102610507,60m_before,0,243,0,243,0,0
102610520,3m_after,0,22,0,22,0,0
102610520,3m_before,0,22,0,22,0,0
102610520,60m_before,0,420,0,420,0,0
102610548,3m_after,0,11,0,11,0,0
102610548,3m_before,0,11,0,11,0,0
102610548,60m_before,0,233,0,233,0,0
102610650,3m_after,0,11,0,11,0,0
102610650,3m_before,0,11,0,11,0,0
102610650,60m_before,0,221,0,221,0,0
102611255,3m_after,0,11,0,11,0,0
102611255,3m_before,0,12,0,12,0,0
102611255,60m_before,0,230,0,230,0,0
102611586,3m_after,0,12,0,12,0,0
102611586,3m_before,0,11,0,11,0,0
102611586,60m_before,0,231,0,231,0,0
102611595,3m_after,0,8,0,8,0,0
102611595,3m_before,0,5,0,5,0,0
102611595,60m_before,0,66,0,66,0,0
102611596,3m_after,0,12,0,12,0,0
102611596,3m_before,0,11,0,11,0,0
102611596,60m_before,0,234,0,234,0,0
102611673,3m_after,0,11,0,11,0,0
102611673,3m_before,0,11,0,11,0,0
102611673,60m_before,0,231,0,231,0,0
102611714,3m_after,0,6,0,6,0,0
102611714,3m_before,0,8,0,8,0,0
102611714,60m_before,0,123,0,123,0,0
102611742,3m_after,0,12,0,12,0,0
102611742,3m_before,0,12,0,12,0,0
102611742,60m_before,0,231,0,231,0,0
102611922,3m_after,0,12,0,12,0,0
102611922,3m_before,0,11,0,11,0,0
102611922,60m_before,0,226,0,226,0,0
102611939,3m_after,0,7,0,7,0,0
102611939,60m_before,2,70,0,72,2,0
102612020,3m_after,0,8,0,8,0,0
102612020,60m_before,0,66,0,66,0,0
102612154,3m_after,0,10,0,10,0,0
102612154,3m_before,0,1,0,1,0,0
102612154,60m_before,0,88,0,88,0,0
102612165,3m_after,0,12,0,12,0,0
102612165,3m_before,0,11,0,11,0,0
102612165,60m_before,0,242,0,242,0,0
102612236,3m_after,0,8,0,8,0,0
102612236,3m_before,1,8,0,9,1,0
102612236,60m_before,2,27,0,29,2,0
102612245,3m_after,0,2,0,2,0,0
102612245,60m_before,0,389,0,389,0,0
102612411,60m_before,8,50,0,58,8,0
102612422,3m_after,1,5,0,6,1,0
102612422,3m_before,0,9,0,9,0,0
102612422,60m_before,2,32,0,34,2,0
102612472,3m_after,0,11,0,11,0,0
102612472,3m_before,0,12,0,12,0,0
102612472,60m_before,0,236,0,236,0,0
102612532,3m_after,0,11,0,11,0,0
102612532,3m_before,0,7,0,7,0,0
102612532,60m_before,0,44,0,44,0,0
102612533,3m_after,0,12,0,12,0,0
102612533,3m_before,0,12,0,12,0,0
102612533,60m_before,0,271,0,271,0,0
102612542,3m_after,0,2,0,2,0,0
102612542,60m_before,2,276,0,278,2,0
102612567,3m_after,0,22,0,22,0,0
102612567,3m_before,0,22,0,22,0,0
102612567,60m_before,0,418,0,418,0,0
102612601,3m_after,0,12,0,12,0,0
102612601,3m_before,0,9,0,9,0,0
102612601,60m_before,0,48,0,48,0,0
102612889,3m_after,0,11,0,11,0,0
102612889,3m_before,0,2,0,2,0,0
102612889,60m_before,0,89,0,89,0,0
102612961,3m_after,0,12,0,12,0,0
102612961,3m_before,0,12,0,12,0,0
102612961,60m_before,1,202,0,203,1,0
102613073,3m_after,0,11,0,11,0,0
102613073,3m_before,0,12,0,12,0,0
102613073,60m_before,0,233,0,233,0,0
102613263,3m_after,0,11,0,11,0,0
102613263,3m_before,0,12,0,12,0,0
102613263,60m_before,0,239,0,239,0,0
102613433,3m_after,0,12,0,12,0,0
102613433,3m_before,0,10,0,10,0,0
102613433,60m_before,0,221,0,221,0,0
102613569,3m_after,0,11,0,11,0,0
102613569,3m_before,0,12,0,12,0,0
102613569,60m_before,1,74,0,75,1,0
102613635,3m_after,0,12,0,12,0,0
102613635,3m_before,0,12,0,12,0,0
102613635,60m_before,0,239,0,239,0,0
102613695,60m_before,2,314,0,316,2,0
102613888,3m_after,0,11,0,11,0,0
102613888,3m_before,0,12,0,12,0,0
102613888,60m_before,0,236,0,236,0,0
102614005,3m_after,0,17,0,17,0,0
102614005,3m_before,0,5,0,5,0,0
102614005,60m_before,0,67,0,67,0,0
102614022,3m_after,0,11,0,11,0,0
102614022,3m_before,0,10,0,10,0,0
102614022,60m_before,2,205,0,207,2,0
102614154,60m_before,0,91,0,91,0,0
102614203,3m_after,0,10,0,10,0,0
102614203,3m_before,0,12,0,12,0,0
102614203,60m_before,0,173,0,173,0,0
102614249,3m_after,0,12,0,12,0,0
102614249,3m_before,0,12,0,12,0,0
102614249,60m_before,1,223,0,224,1,0
102614265,3m_after,0,11,0,11,0,0
102614265,3m_before,1,7,0,8,1,0
102614265,60m_before,2,206,0,208,2,0
102614292,3m_after,0,11,0,11,0,0
102614292,3m_before,0,12,0,12,0,0
102614292,60m_before,0,231,0,231,0,0
102614332,3m_after,0,11,0,11,0,0
102614332,3m_before,0,11,0,11,0,0
102614332,60m_before,0,225,0,225,0,0
102614375,3m_before,1,1,0,2,1,0
102614375,60m_before,3,37,0,40,3,0
102614377,3m_after,0,11,0,11,0,0
102614377,3m_before,0,12,0,12,0,0
102614377,60m_before,0,234,0,234,0,0
102614979,3m_after,0,11,0,11,0,0
102614979,3m_before,0,12,0,12,0,0
102614979,60m_before,0,231,0,231,0,0
102614990,3m_after,0,7,0,7,0,0
102614990,3m_before,0,8,0,8,0,0
102614990,60m_before,0,226,0,226,0,0
102615097,3m_after,0,12,0,12,0,0
102615097,3m_before,0,11,0,11,0,0
102615097,60m_before,1,89,0,90,1,0
102615245,60m_before,3,31,0,34,3,0
102615318,3m_after,0,11,0,11,0,0
102615318,3m_before,0,12,0,12,0,0
102615318,60m_before,1,218,0,219,0,1
102615419,3m_after,0,11,0,11,0,0
102615419,3m_before,0,10,0,10,0,0
102615419,60m_before,0,217,0,217,0,0
102615498,3m_after,0,12,0,12,0,0
102615498,3m_before,0,10,0,10,0,0
102615498,60m_before,0,219,0,219,0,0
102615505,3m_after,0,11,0,11,0,0
102615505,3m_before,0,12,0,12,0,0
102615505,60m_before,0,228,0,228,0,0
102615562,3m_after,0,11,0,11,0,0
102615562,3m_before,0,11,0,11,0,0
102615562,60m_before,0,220,0,220,0,0
102615667,3m_after,0,3,0,3,0,0
102615667,60m_before,0,51,0,51,0,0
102615753,3m_after,0,1,0,1,0,0
102615753,3m_before,0,5,0,5,0,0
102615753,60m_before,0,71,0,71,0,0
102615784,60m_before,3,31,0,34,3,0
102616016,3m_after,0,11,0,11,0,0
102616016,3m_before,0,12,0,12,0,0
102616016,60m_before,0,156,0,156,0,0
102616074,3m_after,0,12,0,12,0,0
102616074,3m_before,0,12,0,12,0,0
102616074,60m_before,0,231,0,231,0,0
102616095,3m_after,0,11,0,11,0,0
102616095,3m_before,1,10,0,11,0,1
102616095,60m_before,1,228,0,229,0,1
102616131,3m_after,0,12,0,12,0,0
102616131,3m_before,0,11,0,11,0,0
102616131,60m_before,0,228,0,228,0,0
102616141,3m_after,0,5,0,5,0,0
102616141,3m_before,0,10,0,10,0,0
102616141,60m_before,0,37,0,37,0,0
102616155,60m_before,8,24,0,32,8,0
102616258,3m_after,0,11,0,11,0,0
102616258,3m_before,0,12,0,12,0,0
102616258,60m_before,1,103,0,104,1,0
102616288,3m_after,0,12,0,12,0,0
102616288,3m_before,0,11,0,11,0,0
102616288,60m_before,0,110,0,110,0,0
102616443,3m_after,1,5,0,6,1,0
102616443,3m_before,0,3,0,3,0,0
102616443,60m_before,0,69,0,69,0,0
102616497,3m_after,0,12,0,12,0,0
102616497,3m_before,0,11,0,11,0,0
102616497,60m_before,0,235,0,235,0,0
102616513,3m_after,0,12,0,12,0,0
102616513,3m_before,0,11,0,11,0,0
102616513,60m_before,0,227,0,227,0,0
102616604,3m_after,0,9,0,9,0,0
102616604,3m_before,0,11,0,11,0,0
102616604,60m_before,0,234,0,234,0,0
102616628,3m_after,0,11,0,11,0,0
102616628,3m_before,0,12,0,12,0,0
102616628,60m_before,0,195,0,195,0,0
102616715,3m_after,0,7,0,7,0,0
102616812,3m_after,0,3,0,3,0,0
102616812,60m_before,1,25,0,26,1,0
102616823,3m_after,0,12,0,12,0,0
102616823,3m_before,0,11,0,11,0,0
102616823,60m_before,2,214,0,216,2,0
102616866,3m_after,0,11,0,11,0,0
102616866,3m_before,0,12,0,12,0,0
102616866,60m_before,2,282,0,284,2,0
102617061,3m_before,0,1,0,1,0,0
102617061,60m_before,0,70,0,70,0,0
102617124,3m_after,0,1,0,1,0,0
102617238,3m_after,0,12,0,12,0,0
102617238,3m_before,0,9,0,9,0,0
102617238,60m_before,2,279,0,281,2,0
102617407,3m_after,0,12,0,12,0,0
102617407,3m_before,0,11,0,11,0,0
102617407,60m_before,0,231,0,231,0,0
102617532,3m_after,2,0,0,2,2,0
102617532,3m_before,0,20,0,20,0,0
102617532,60m_before,2,452,0,454,0,2
102617868,3m_after,0,12,0,12,0,0
102617868,3m_before,0,11,0,11,0,0
102617868,60m_before,0,226,0,226,0,0
102618049,3m_after,0,11,0,11,0,0
102618049,3m_before,0,11,0,11,0,0
102618049,60m_before,0,220,0,220,0,0
102618114,60m_before,3,31,0,34,3,0
102618160,3m_after,0,11,0,11,0,0
102618160,3m_before,0,12,0,12,0,0
102618160,60m_before,2,214,0,216,2,0
102618163,3m_after,0,11,0,11,0,0
102618163,3m_before,0,10,0,10,0,0
102618163,60m_before,0,141,0,141,0,0
102618201,3m_after,0,12,0,12,0,0
102618201,3m_before,0,12,0,12,0,0
102618201,60m_before,0,232,0,232,0,0
102618288,60m_before,3,31,0,34,3,0
102618305,3m_after,0,12,0,12,0,0
102618305,3m_before,0,12,0,12,0,0
102618305,60m_before,0,153,0,153,0,0
102618813,3m_after,0,21,0,21,0,0
102618813,3m_before,0,22,0,22,0,0
102618813,60m_before,0,413,0,413,0,0
102618816,3m_after,0,2,0,2,0,0
102618816,3m_before,0,1,0,1,0,0
102618816,60m_before,2,109,0,111,2,0
102618845,3m_after,0,1,0,1,0,0
102618845,3m_before,0,7,0,7,0,0
102618845,60m_before,0,38,0,38,0,0
102618850,3m_after,0,12,0,12,0,0
102618850,3m_before,0,11,0,11,0,0
102618850,60m_before,0,230,0,230,0,0
102619017,3m_after,0,7,0,7,0,0
102619017,3m_before,0,3,0,3,0,0
102619017,60m_before,0,91,0,91,0,0
102619062,3m_after,0,4,0,4,0,0
102619062,3m_before,0,5,0,5,0,0
102619062,60m_before,0,75,0,75,0,0
102619092,3m_after,0,11,0,11,0,0
102619092,3m_before,0,10,0,10,0,0
102619092,60m_before,0,198,0,198,0,0
102619192,3m_after,0,12,0,12,0,0
102619192,3m_before,0,12,0,12,0,0
102619192,60m_before,0,235,0,235,0,0
102619316,3m_after,0,11,0,11,0,0
102619316,3m_before,0,11,0,11,0,0
102619316,60m_before,0,220,0,220,0,0
102619354,3m_after,0,11,0,11,0,0
102619354,3m_before,0,11,0,11,0,0
102619354,60m_before,0,227,0,227,0,0
102619395,60m_before,4,412,0,416,2,2
102619474,3m_after,0,21,0,21,0,0
102619474,3m_before,0,12,0,12,0,0
102619474,60m_before,2,215,0,217,2,0
102619503,3m_after,0,12,0,12,0,0
102619503,3m_before,0,12,0,12,0,0
102619503,60m_before,9,355,0,364,0,9
102619595,3m_after,0,11,0,11,0,0
102619595,3m_before,0,12,0,12,0,0
102619595,60m_before,0,159,0,159,0,0
102619694,60m_before,1,0,0,1,1,0
102619759,3m_after,0,7,0,7,0,0
102619759,3m_before,1,7,0,8,1,0
102619759,60m_before,6,188,0,194,6,0
102619780,3m_after,0,12,0,12,0,0
102619780,3m_before,0,11,0,11,0,0
102619780,60m_before,13,78,0,91,12,1
102619919,3m_after,0,20,0,20,0,0
102619919,3m_before,0,11,0,11,0,0
102619919,60m_before,0,154,0,154,0,0
102620125,3m_after,0,11,0,11,0,0
102620125,3m_before,0,12,0,12,0,0
102620125,60m_before,0,178,0,178,0,0
102620389,3m_after,0,12,0,12,0,0
102620389,3m_before,0,11,0,11,0,0
102620389,60m_before,5,170,0,175,2,3
102620484,3m_after,0,11,0,11,0,0
102620484,3m_before,0,11,0,11,0,0
102620484,60m_before,0,234,0,234,0,0
102620518,3m_after,0,12,0,12,0,0
102620518,3m_before,0,10,0,10,0,0
102620518,60m_before,0,144,0,144,0,0
102620617,3m_after,0,12,0,12,0,0
102620617,3m_before,0,11,0,11,0,0
102620617,60m_before,0,242,0,242,0,0
102620646,3m_after,0,10,0,10,0,0
102620646,3m_before,0,8,0,8,0,0
102620646,60m_before,0,191,0,191,0,0
102620707,60m_before,8,15,0,23,8,0
102620785,3m_after,0,5,1,6,0,1
102620785,60m_before,0,17,1,18,0,1
102620803,3m_after,0,12,0,12,0,0
102620803,3m_before,0,11,0,11,0,0
102620803,60m_before,9,342,0,351,0,9
102620830,3m_after,0,11,0,11,0,0
102620830,3m_before,0,11,0,11,0,0
102620830,60m_before,0,232,0,232,0,0
102620883,3m_after,0,12,0,12,0,0
102620883,3m_before,0,11,0,11,0,0
102620883,60m_before,0,244,0,244,0,0
102620932,3m_before,0,8,0,8,0,0
102620932,60m_before,2,269,0,271,2,0
102621078,3m_after,0,11,0,11,0,0
102621078,3m_before,0,12,0,12,0,0
102621078,60m_before,0,235,0,235,0,0
102621126,3m_after,0,11,0,11,0,0
102621126,3m_before,0,11,0,11,0,0
102621126,60m_before,1,228,0,229,0,1
102621303,3m_after,0,12,0,12,0,0
102621303,3m_before,0,12,0,12,0,0
102621303,60m_before,0,222,0,222,0,0
102621359,3m_after,0,11,0,11,0,0
102621359,3m_before,0,10,0,10,0,0
102621359,60m_before,0,225,0,225,0,0
102621422,3m_after,0,11,0,11,0,0
102621422,3m_before,1,7,0,8,1,0
102621422,60m_before,3,205,0,208,3,0
102621504,3m_after,0,15,0,15,0,0
102621504,3m_before,0,11,0,11,0,0
102621504,60m_before,9,334,0,343,0,9
102621585,3m_after,0,11,0,11,0,0
102621585,3m_before,0,11,0,11,0,0
102621585,60m_before,1,227,0,228,0,1
102621676,3m_after,0,12,0,12,0,0
102621676,3m_before,0,11,0,11,0,0
102621676,60m_before,0,234,0,234,0,0
102621953,60m_before,0,60,0,60,0,0
102622007,3m_after,0,12,0,12,0,0
102622007,3m_before,0,11,0,11,0,0
102622007,60m_before,2,214,0,216,2,0
102622250,3m_after,0,12,0,12,0,0
102622250,3m_before,0,11,0,11,0,0
102622250,60m_before,0,231,0,231,0,0
102622347,3m_after,0,12,0,12,0,0
102622347,3m_before,0,12,0,12,0,0
102622347,60m_before,0,232,0,232,0,0
102622416,3m_after,0,12,0,12,0,0
102622416,3m_before,0,12,0,12,0,0
102622416,60m_before,1,169,0,170,1,0
102622434,3m_after,0,11,0,11,0,0
102622434,3m_before,0,12,0,12,0,0
102622434,60m_before,0,233,0,233,0,0
102622454,3m_after,0,16,0,16,0,0
102622454,3m_before,0,11,0,11,0,0
102622454,60m_before,0,243,0,243,0,0
102622473,3m_after,0,11,0,11,0,0
102622473,3m_before,0,12,0,12,0,0
102622473,60m_before,0,231,0,231,0,0
102622655,60m_before,3,31,0,34,3,0
102622798,3m_after,0,8,0,8,0,0
102622798,3m_before,0,9,0,9,0,0
102622798,60m_before,5,190,0,195,5,0
102622839,3m_after,0,11,0,11,0,0
102622839,3m_before,0,11,0,11,0,0
102622839,60m_before,0,247,0,247,0,0
102622880,3m_after,0,12,0,12,0,0
102622880,3m_before,0,12,0,12,0,0
102622880,60m_before,0,227,0,227,0,0
102622994,3m_after,0,12,0,12,0,0
102622994,3m_before,0,11,0,11,0,0
102622994,60m_before,0,239,0,239,0,0
102623026,60m_before,0,364,0,364,0,0
102623060,3m_after,0,11,0,11,0,0
102623060,3m_before,0,12,0,12,0,0
102623060,60m_before,0,217,0,217,0,0
102623076,60m_before,3,25,0,28,3,0
102623130,3m_after,0,10,0,10,0,0
102623130,3m_before,0,11,0,11,0,0
102623130,60m_before,0,225,0,225,0,0
102623157,3m_after,0,12,0,12,0,0
102623157,3m_before,0,12,0,12,0,0
102623157,60m_before,0,233,0,233,0,0
102623159,3m_after,0,7,0,7,0,0
102623159,3m_before,0,1,0,1,0,0
102623159,60m_before,0,77,0,77,0,0
102623258,3m_after,0,12,0,12,0,0
102623258,3m_before,0,12,0,12,0,0
102623258,60m_before,0,233,0,233,0,0
102623277,3m_after,0,12,0,12,0,0
102623277,3m_before,0,11,0,11,0,0
102623277,60m_before,0,231,0,231,0,0
102623450,3m_after,0,18,0,18,0,0
102623450,3m_before,0,22,0,22,0,0
102623450,60m_before,0,405,0,405,0,0
102623524,3m_after,0,11,0,11,0,0
102623524,3m_before,0,12,0,12,0,0
102623524,60m_before,0,194,0,194,0,0
102623694,3m_after,0,12,0,12,0,0
102623694,3m_before,0,11,0,11,0,0
102623694,60m_before,0,232,0,232,0,0
102623716,3m_after,1,10,0,11,1,0
102623716,60m_before,0,58,0,58,0,0
102623854,3m_before,0,1,0,1,0,0
102623854,60m_before,0,68,0,68,0,0
102623924,3m_after,0,12,0,12,0,0
102623924,3m_before,1,5,0,6,1,0
102623924,60m_before,8,170,0,178,8,0
102623962,3m_after,0,11,0,11,0,0
102623962,3m_before,0,12,0,12,0,0
102623962,60m_before,0,193,0,193,0,0
102624013,60m_before,3,25,0,28,3,0
102624212,60m_before,3,25,0,28,3,0
102624247,3m_after,0,11,0,11,0,0
102624247,3m_before,0,11,0,11,0,0
102624247,60m_before,0,248,0,248,0,0
102624404,60m_before,3,25,0,28,3,0
102624424,60m_before,3,25,0,28,3,0
102624440,3m_after,0,19,0,19,0,0
102624440,3m_before,0,19,0,19,0,0
102624440,60m_before,0,410,0,410,0,0
102624509,60m_before,0,74,0,74,0,0
102624530,3m_after,0,11,0,11,0,0
102624530,3m_before,0,11,0,11,0,0
102624530,60m_before,2,234,0,236,2,0
102624784,3m_after,0,11,0,11,0,0
102624784,3m_before,0,12,0,12,0,0
102624784,60m_before,1,227,0,228,0,1
102624806,60m_before,3,25,0,28,3,0
102624831,3m_after,0,11,0,11,0,0
102624831,3m_before,0,12,0,12,0,0
102624831,60m_before,0,227,0,227,0,0
102625018,60m_before,3,25,0,28,3,0
102625144,3m_after,0,10,0,10,0,0
102625144,3m_before,0,11,0,11,0,0
102625144,60m_before,0,222,0,222,0,0
102625160,3m_after,0,11,0,11,0,0
102625160,3m_before,1,7,0,8,1,0
102625160,60m_before,4,199,0,203,4,0
102625240,60m_before,3,25,0,28,3,0
102625297,60m_before,3,25,0,28,3,0
102625331,3m_before,0,5,0,5,0,0
102625331,60m_before,0,219,0,219,0,0
102625591,3m_after,0,10,0,10,0,0
102625591,3m_before,0,12,0,12,0,0
102625591,60m_before,0,223,0,223,0,0
102625626,3m_after,0,8,0,8,0,0
102625626,60m_before,0,27,0,27,0,0
102625670,3m_after,0,10,0,10,0,0
102625670,3m_before,0,11,0,11,0,0
102625670,60m_before,12,283,0,295,0,12
102625764,3m_before,0,1,0,1,0,0
102625764,60m_before,0,14,0,14,0,0
102625893,3m_after,0,9,0,9,0,0
102625893,3m_before,0,1,0,1,0,0
102625893,60m_before,0,80,0,80,0,0
102625935,3m_after,0,12,0,12,0,0
102625935,3m_before,0,11,0,11,0,0
102625935,60m_before,0,233,0,233,0,0
102625970,3m_after,0,12,0,12,0,0
102625970,3m_before,0,11,0,11,0,0
102625970,60m_before,0,232,0,232,0,0
102626019,3m_after,0,8,0,8,0,0
102626019,60m_before,0,24,2,26,0,2
102626099,3m_after,0,12,0,12,0,0
102626099,3m_before,0,12,0,12,0,0
102626099,60m_before,0,207,0,207,0,0
102626145,3m_after,0,11,0,11,0,0
102626145,3m_before,0,12,0,12,0,0
102626145,60m_before,0,232,0,232,0,0
102626165,3m_after,0,11,0,11,0,0
102626165,3m_before,0,12,0,12,0,0
102626165,60m_before,0,215,0,215,0,0
102626256,3m_after,0,12,0,12,0,0
102626256,3m_before,0,12,0,12,0,0
102626256,60m_before,0,231,0,231,0,0
102626591,3m_after,0,12,0,12,0,0
102626591,3m_before,0,12,0,12,0,0
102626591,60m_before,0,226,0,226,0,0
102626632,3m_after,1,7,0,8,1,0
102626632,3m_before,0,4,0,4,0,0
102626632,60m_before,0,28,2,30,0,2
102626683,3m_after,0,3,0,3,0,0
102626683,60m_before,0,100,0,100,0,0
102626730,3m_after,0,11,0,11,0,0
102626730,3m_before,0,12,0,12,0,0
102626730,60m_before,8,120,0,128,8,0
102626747,3m_after,2,17,0,19,0,2
102626747,3m_before,2,14,0,16,0,2
102626747,60m_before,6,285,0,291,2,4
102626772,3m_after,1,8,0,9,1,0
102626772,3m_before,0,11,0,11,0,0
102626772,60m_before,8,169,0,177,8,0
102626841,60m_before,3,25,0,28,3,0
102626894,3m_after,0,12,0,12,0,0
102626894,3m_before,0,12,0,12,0,0
102626894,60m_before,0,235,0,235,0,0
102626939,3m_after,0,8,0,8,0,0
102626939,60m_before,2,348,0,350,0,2
102626969,3m_after,0,12,0,12,0,0
102626969,3m_before,0,11,0,11,0,0
102626969,60m_before,0,232,0,232,0,0
102627058,3m_after,0,12,0,12,0,0
102627058,3m_before,0,11,0,11,0,0
102627058,60m_before,0,190,0,190,0,0
102627234,3m_after,0,11,0,11,0,0
102627234,3m_before,0,12,0,12,0,0
102627234,60m_before,0,226,0,226,0,0
102627343,60m_before,3,25,0,28,3,0
102627394,3m_after,0,5,0,5,0,0
102627394,3m_before,0,11,0,11,0,0
102627394,60m_before,0,62,0,62,0,0
102627402,60m_before,3,25,0,28,3,0
102627411,3m_after,0,7,0,7,0,0
102627411,3m_before,0,10,0,10,0,0
102627411,60m_before,0,205,0,205,0,0
102627621,3m_after,0,11,0,11,0,0
102627621,3m_before,0,12,0,12,0,0
102627621,60m_before,5,179,0,184,5,0
102627636,3m_after,0,12,0,12,0,0
102627636,3m_before,0,12,0,12,0,0
102627636,60m_before,0,228,0,228,0,0
102627691,3m_after,0,11,0,11,0,0
102627691,3m_before,0,12,0,12,0,0
102627691,60m_before,0,206,0,206,0,0
102627789,3m_after,0,12,0,12,0,0
102627789,3m_before,0,11,0,11,0,0
102627789,60m_before,0,227,0,227,0,0
102627950,3m_after,0,5,0,5,0,0
102627950,60m_before,0,29,0,29,0,0
102628071,3m_after,0,9,0,9,0,0
102628071,3m_before,0,6,0,6,0,0
102628071,60m_before,0,102,0,102,0,0
102628076,60m_before,3,25,0,28,3,0
102628092,3m_before,0,11,0,11,0,0
102628092,60m_before,1,225,0,226,1,0
102628387,60m_before,3,25,0,28,3,0
102628425,3m_after,0,11,0,11,0,0
102628425,3m_before,0,3,0,3,0,0
102628425,60m_before,4,57,0,61,2,2
102628465,3m_after,0,2,0,2,0,0
102628465,60m_before,0,23,0,23,0,0
102628720,3m_after,0,7,0,7,0,0
102628720,3m_before,0,2,0,2,0,0
102628720,60m_before,0,77,0,77,0,0
102628758,3m_after,0,12,0,12,0,0
102628758,3m_before,0,11,0,11,0,0
102628758,60m_before,0,227,0,227,0,0
102628844,3m_after,0,11,0,11,0,0
102628844,3m_before,0,12,0,12,0,0
102628844,60m_before,0,227,0,227,0,0
102628881,60m_before,3,25,0,28,3,0
102629083,3m_after,0,11,0,11,0,0
102629083,3m_before,0,11,0,11,0,0
102629083,60m_before,0,211,0,211,0,0
102629172,3m_after,0,12,0,12,0,0
102629172,3m_before,0,12,0,12,0,0
102629172,60m_before,0,233,0,233,0,0
102629217,3m_after,0,11,0,11,0,0
102629217,3m_before,0,12,0,12,0,0
102629217,60m_before,0,233,0,233,0,0
102629241,3m_after,0,11,0,11,0,0
102629241,3m_before,0,12,0,12,0,0
102629241,60m_before,1,228,0,229,1,0
102629350,3m_after,0,10,0,10,0,0
102629350,3m_before,0,11,0,11,0,0
102629350,60m_before,4,200,0,204,4,0
102629545,3m_after,0,12,0,12,0,0
102629545,3m_before,0,12,0,12,0,0
102629545,60m_before,0,232,0,232,0,0
102629623,3m_after,0,11,0,11,0,0
102629623,3m_before,0,12,0,12,0,0
102629623,60m_before,0,226,0,226,0,0
102629650,3m_after,0,1,0,1,0,0
102629650,60m_before,0,31,0,31,0,0
102629982,3m_after,0,12,0,12,0,0
102629982,3m_before,0,11,0,11,0,0
102629982,60m_before,9,165,0,174,9,0
102630150,3m_after,0,12,0,12,0,0
102630150,3m_before,0,12,0,12,0,0
102630150,60m_before,0,233,0,233,0,0
102630230,3m_after,0,11,0,11,0,0
102630230,3m_before,0,12,0,12,0,0
102630230,60m_before,0,191,0,191,0,0
102630324,3m_before,0,3,0,3,0,0
102630324,60m_before,0,205,0,205,0,0
102630375,3m_after,0,10,0,10,0,0
102630375,3m_before,0,11,0,11,0,0
102630375,60m_before,4,199,0,203,4,0
102630623,3m_after,0,22,0,22,0,0
102630623,3m_before,0,24,0,24,0,0
102630623,60m_before,0,431,0,431,0,0
102630732,3m_after,0,10,0,10,0,0
102630732,3m_before,0,11,0,11,0,0
102630732,60m_before,0,213,0,213,0,0
102630745,3m_after,0,11,0,11,0,0
102630745,3m_before,0,12,0,12,0,0
102630745,60m_before,0,230,0,230,0,0
102630786,3m_after,0,22,0,22,0,0
102630786,3m_before,0,24,0,24,0,0
102630786,60m_before,0,431,0,431,0,0
102630824,3m_after,0,21,0,21,0,0
102630824,3m_before,0,24,0,24,0,0
102630824,60m_before,0,341,0,341,0,0
102630843,3m_after,0,12,0,12,0,0
102630843,3m_before,0,11,0,11,0,0
102630843,60m_before,0,227,0,227,0,0
102630877,3m_after,0,12,0,12,0,0
102630877,3m_before,0,12,0,12,0,0
102630877,60m_before,0,231,0,231,0,0
102630998,3m_after,0,10,0,10,0,0
102630998,3m_before,0,11,0,11,0,0
102630998,60m_before,0,62,0,62,0,0
102631267,3m_after,0,11,0,11,0,0
102631267,3m_before,0,12,0,12,0,0
102631267,60m_before,1,227,0,228,1,0
102631370,60m_before,0,19,0,19,0,0
102631513,3m_after,0,12,0,12,0,0
102631513,3m_before,0,10,0,10,0,0
102631513,60m_before,0,234,0,234,0,0
102631536,3m_after,0,2,0,2,0,0
102631536,3m_before,1,0,0,1,1,0
102631536,60m_before,1,219,0,220,1,0
102631583,3m_after,0,11,0,11,0,0
102631583,3m_before,0,12,0,12,0,0
102631583,60m_before,0,232,0,232,0,0
102631663,3m_after,0,12,0,12,0,0
102631663,3m_before,0,11,0,11,0,0
102631663,60m_before,0,230,0,230,0,0
102631669,3m_after,0,10,0,10,0,0
102631669,3m_before,1,8,0,9,1,0
102631669,60m_before,5,197,0,202,5,0
102631740,3m_after,0,10,0,10,0,0
102631740,3m_before,1,8,0,9,1,0
102631740,60m_before,5,197,0,202,5,0
102631815,3m_after,0,4,0,4,0,0
102631815,60m_before,0,193,0,193,0,0
102631897,3m_after,0,11,0,11,0,0
102631897,3m_before,0,12,0,12,0,0
102631897,60m_before,0,198,0,198,0,0
102632000,3m_after,0,9,0,9,0,0
102632000,3m_before,0,10,0,10,0,0
102632000,60m_before,5,197,0,202,5,0
102632093,3m_before,0,1,0,1,0,0
102632093,60m_before,1,13,0,14,1,0
102632202,60m_before,0,68,0,68,0,0
102632359,3m_after,0,11,0,11,0,0
102632359,3m_before,0,12,0,12,0,0
102632359,60m_before,1,246,0,247,1,0
102632453,3m_after,0,12,0,12,0,0
102632453,3m_before,0,11,0,11,0,0
102632453,60m_before,0,128,0,128,0,0
102632571,3m_after,0,12,0,12,0,0
102632571,3m_before,0,12,0,12,0,0
102632571,60m_before,0,233,0,233,0,0
102632818,3m_after,0,5,0,5,0,0
102632818,3m_before,0,2,0,2,0,0
102632818,60m_before,0,70,0,70,0,0
102632859,3m_after,0,12,0,12,0,0
102632859,3m_before,0,11,0,11,0,0
102632859,60m_before,1,218,0,219,1,0
102632865,60m_before,1,12,0,13,1,0
102633021,3m_before,0,1,0,1,0,0
102633021,60m_before,0,43,0,43,0,0
102633085,3m_after,0,12,0,12,0,0
102633085,3m_before,0,11,0,11,0,0
102633085,60m_before,0,227,0,227,0,0
102633102,3m_after,0,11,0,11,0,0
102633102,3m_before,0,11,0,11,0,0
102633102,60m_before,1,226,0,227,1,0
102633195,3m_after,0,12,0,12,0,0
102633195,3m_before,0,12,0,12,0,0
102633195,60m_before,0,234,0,234,0,0
102633333,3m_after,0,11,0,11,0,0
102633333,3m_before,0,12,0,12,0,0
102633333,60m_before,0,192,0,192,0,0
102633371,60m_before,1,7,0,8,1,0
102633404,3m_after,1,8,0,9,1,0
102633404,3m_before,0,12,0,12,0,0
102633404,60m_before,8,173,0,181,8,0
102633453,3m_after,0,11,0,11,0,0
102633453,3m_before,0,12,0,12,0,0
102633453,60m_before,1,246,0,247,1,0
102633511,60m_before,1,6,0,7,1,0
102633559,60m_before,1,21,0,22,1,0
102633566,3m_after,0,12,0,12,0,0
102633566,3m_before,0,11,0,11,0,0
102633566,60m_before,0,227,0,227,0,0
102633568,3m_after,0,12,0,12,0,0
102633568,3m_before,0,11,0,11,0,0
102633568,60m_before,0,233,0,233,0,0
102633608,3m_after,0,23,0,23,0,0
102633608,3m_before,0,24,0,24,0,0
102633608,60m_before,2,359,0,361,0,2
102633613,3m_after,0,11,0,11,0,0
102633613,3m_before,0,12,0,12,0,0
102633613,60m_before,0,230,0,230,0,0
102633700,3m_after,0,9,0,9,0,0
102633700,3m_before,0,10,0,10,0,0
102633700,60m_before,5,195,0,200,5,0
102633726,3m_after,0,12,0,12,0,0
102633726,3m_before,0,12,0,12,0,0
102633726,60m_before,0,235,0,235,0,0
102633823,3m_after,0,11,0,11,0,0
102633823,3m_before,0,12,0,12,0,0
102633823,60m_before,0,128,0,128,0,0
102633841,3m_after,1,4,0,5,1,0
102633841,3m_before,1,3,0,4,1,0
102633841,60m_before,1,3,0,4,1,0
102633885,60m_before,0,123,0,123,0,0
102633987,60m_before,1,1,0,2,1,0
102634061,60m_before,1,1,0,2,1,0
102634110,60m_before,1,127,0,128,1,0
102634130,3m_after,0,12,0,12,0,0
102634130,3m_before,0,11,0,11,0,0
102634130,60m_before,0,234,0,234,0,0
102634180,3m_after,0,11,0,11,0,0
102634180,3m_before,0,11,0,11,0,0
102634180,60m_before,4,184,0,188,4,0
102634182,3m_after,0,12,0,12,0,0
102634182,3m_before,0,11,0,11,0,0
102634182,60m_before,0,231,0,231,0,0
102634226,3m_after,0,12,0,12,0,0
102634226,3m_before,0,11,0,11,0,0
102634226,60m_before,0,209,0,209,0,0
102634248,60m_before,0,1,0,1,0,0
102634330,3m_after,0,10,0,10,0,0
102634330,3m_before,0,11,0,11,0,0
102634330,60m_before,2,204,0,206,2,0
102634338,3m_after,0,10,0,10,0,0
102634338,3m_before,0,9,0,9,0,0
102634338,60m_before,5,195,0,200,5,0
102634355,3m_after,0,11,0,11,0,0
102634355,3m_before,0,11,0,11,0,0
102634355,60m_before,0,192,0,192,0,0
102634359,3m_after,0,12,0,12,0,0
102634359,3m_before,0,11,0,11,0,0
102634359,60m_before,0,231,0,231,0,0
102634422,3m_after,0,11,0,11,0,0
102634422,3m_before,0,12,0,12,0,0
102634422,60m_before,0,228,0,228,0,0
102634492,60m_before,0,32,0,32,0,0
102634540,3m_after,0,8,0,8,0,0
102634540,60m_before,0,51,0,51,0,0
102634580,3m_after,0,11,0,11,0,0
102634580,3m_before,0,11,0,11,0,0
102634580,60m_before,0,232,0,232,0,0
102634626,3m_after,0,11,0,11,0,0
102634626,3m_before,0,10,0,10,0,0
102634626,60m_before,0,213,0,213,0,0
102634678,3m_after,0,11,0,11,0,0
102634678,3m_before,0,11,0,11,0,0
102634678,60m_before,0,192,0,192,0,0
102634860,3m_after,0,5,0,5,0,0
102634860,3m_before,0,8,0,8,0,0
102634860,60m_before,0,44,0,44,0,0
102634890,3m_after,0,11,0,11,0,0
102634890,3m_before,0,11,0,11,0,0
102634890,60m_before,3,195,0,198,3,0
102634942,3m_after,0,12,0,12,0,0
102634942,3m_before,0,11,0,11,0,0
102634942,60m_before,0,232,0,232,0,0
102634964,3m_after,0,11,0,11,0,0
102634964,3m_before,0,11,0,11,0,0
102634964,60m_before,0,214,0,214,0,0
102634986,3m_after,0,12,0,12,0,0
102634986,3m_before,0,11,0,11,0,0
102634986,60m_before,1,218,0,219,1,0
102635024,3m_after,0,11,0,11,0,0
102635024,3m_before,0,12,0,12,0,0
102635024,60m_before,0,232,0,232,0,0
102635341,3m_after,0,7,0,7,0,0
102635341,3m_before,0,8,0,8,0,0
102635341,60m_before,4,194,0,198,4,0
102635369,60m_before,0,150,0,150,0,0
102635436,3m_after,0,11,0,11,0,0
102635436,3m_before,0,12,0,12,0,0
102635436,60m_before,0,234,0,234,0,0
102635538,3m_after,0,12,0,12,0,0
102635538,3m_before,0,11,0,11,0,0
102635538,60m_before,0,231,0,231,0,0
102635551,3m_after,0,11,0,11,0,0
102635551,3m_before,0,10,0,10,0,0
102635551,60m_before,2,200,0,202,2,0
102635648,3m_after,0,12,0,12,0,0
102635648,3m_before,0,11,0,11,0,0
102635648,60m_before,0,231,0,231,0,0
102635699,3m_after,0,12,0,12,0,0
102635699,3m_before,0,11,0,11,0,0
102635699,60m_before,0,198,0,198,0,0
102635832,3m_after,0,11,0,11,0,0
102635832,3m_before,0,12,0,12,0,0
102635832,60m_before,0,224,0,224,0,0
102635940,60m_before,8,67,0,75,8,0
102636015,3m_after,0,12,0,12,0,0
102636015,3m_before,0,12,0,12,0,0
102636015,60m_before,1,218,0,219,1,0
102636080,3m_before,0,1,0,1,0,0
102636080,60m_before,3,49,0,52,0,3
102636081,3m_after,0,10,0,10,0,0
102636081,3m_before,0,10,0,10,0,0
102636081,60m_before,2,186,0,188,2,0
102636088,3m_after,0,12,0,12,0,0
102636088,3m_before,0,5,0,5,0,0
102636088,60m_before,0,51,0,51,0,0
102636296,3m_after,0,12,0,12,0,0
102636296,3m_before,0,11,0,11,0,0
102636296,60m_before,0,232,0,232,0,0
102636337,3m_after,0,11,0,11,0,0
102636337,3m_before,0,11,0,11,0,0
102636337,60m_before,0,215,0,215,0,0
102636384,3m_after,0,10,0,10,0,0
102636384,3m_before,0,12,0,12,0,0
102636384,60m_before,0,230,0,230,0,0
102636527,60m_before,0,22,0,22,0,0
102636802,3m_after,0,9,0,9,0,0
102636802,3m_before,2,7,0,9,0,2
102636802,60m_before,3,17,0,20,0,3
102636808,3m_after,0,11,0,11,0,0
102636808,3m_before,0,12,0,12,0,0
102636808,60m_before,0,226,0,226,0,0
102636909,3m_after,0,12,0,12,0,0
102636909,3m_before,0,11,0,11,0,0
102636909,60m_before,0,231,0,231,0,0
102637082,3m_after,0,24,0,24,0,0
102637082,3m_before,0,23,0,23,0,0
102637082,60m_before,0,364,0,364,0,0
102637245,3m_after,1,7,0,8,1,0
102637245,3m_before,0,10,0,10,0,0
102637245,60m_before,5,31,0,36,5,0
102637336,3m_after,0,8,0,8,0,0
102637336,3m_before,0,4,0,4,0,0
102637336,60m_before,0,67,0,67,0,0
102637354,3m_after,0,12,0,12,0,0
102637354,3m_before,0,12,0,12,0,0
102637354,60m_before,0,231,0,231,0,0
102637356,3m_after,0,22,0,22,0,0
102637356,3m_before,4,6,0,10,2,2
102637356,60m_before,12,230,0,242,2,10
102637405,3m_after,0,11,0,11,0,0
102637405,3m_before,0,11,0,11,0,0
102637405,60m_before,0,231,0,231,0,0
102637423,3m_after,0,12,0,12,0,0
102637423,3m_before,0,11,0,11,0,0
102637423,60m_before,0,230,0,230,0,0
102637591,3m_after,0,8,0,8,0,0
102637591,60m_before,0,45,0,45,0,0
102637672,3m_after,0,23,0,23,0,0
102637672,3m_before,0,23,0,23,0,0
102637672,60m_before,2,357,0,359,0,2
102637717,3m_after,0,22,0,22,0,0
102637717,3m_before,0,22,0,22,0,0
102637717,60m_before,0,441,0,441,0,0
102637746,3m_after,0,12,0,12,0,0
102637746,3m_before,0,11,0,11,0,0
102637746,60m_before,0,208,0,208,0,0
102637878,3m_before,0,1,0,1,0,0
102637878,60m_before,2,154,0,156,2,0
102638133,3m_after,0,11,0,11,0,0
102638133,3m_before,0,10,0,10,0,0
102638133,60m_before,0,208,0,208,0,0
102638234,3m_after,0,9,0,9,0,0
102638234,3m_before,0,6,0,6,0,0
102638234,60m_before,0,72,0,72,0,0
102638276,3m_after,0,24,0,24,0,0
102638276,3m_before,0,24,0,24,0,0
102638276,60m_before,12,249,0,261,2,10
102638299,3m_after,0,11,0,11,0,0
102638299,3m_before,0,12,0,12,0,0
102638299,60m_before,0,233,0,233,0,0
102638324,3m_after,0,8,0,8,0,0
102638324,3m_before,0,8,0,8,0,0
102638324,60m_before,0,72,0,72,0,0
102638334,3m_after,0,11,0,11,0,0
102638334,3m_before,0,12,0,12,0,0
102638334,60m_before,0,232,0,232,0,0
102638343,3m_after,1,0,0,1,1,0
102638343,60m_before,3,44,0,47,0,3
102638415,3m_after,0,12,0,12,0,0
102638415,3m_before,0,10,0,10,0,0
102638415,60m_before,0,227,0,227,0,0
102638439,60m_before,0,32,0,32,0,0
102638503,3m_after,0,11,0,11,0,0
102638503,3m_before,0,1,0,1,0,0
102638503,60m_before,0,27,0,27,0,0
102638604,3m_after,0,12,0,12,0,0
102638604,3m_before,0,12,0,12,0,0
102638604,60m_before,0,234,0,234,0,0
102638620,3m_after,0,12,0,12,0,0
102638620,3m_before,0,10,0,10,0,0
102638620,60m_before,0,212,0,212,0,0
102638647,3m_after,0,11,0,11,0,0
102638647,3m_before,0,13,0,13,0,0
102638647,60m_before,0,229,0,229,0,0
102638731,3m_after,0,6,0,6,0,0
102638731,3m_before,0,11,0,11,0,0
102638731,60m_before,0,139,0,139,0,0
102638749,3m_after,0,11,0,11,0,0
102638749,3m_before,0,11,0,11,0,0
102638749,60m_before,5,204,0,209,5,0
102638821,3m_after,0,9,0,9,0,0
102638821,3m_before,0,10,0,10,0,0
102638821,60m_before,4,194,0,198,4,0
102638831,3m_after,0,13,0,13,0,0
102638831,3m_before,0,9,0,9,0,0
102638831,60m_before,0,230,0,230,0,0
102638851,3m_after,0,11,0,11,0,0
102638851,3m_before,0,11,0,11,0,0
102638851,60m_before,0,228,0,228,0,0
102638886,3m_after,0,9,0,9,0,0
102638886,3m_before,0,11,0,11,0,0
102638886,60m_before,1,126,0,127,1,0
102638941,3m_after,0,12,0,12,0,0
102638941,3m_before,0,11,0,11,0,0
102638941,60m_before,0,230,0,230,0,0
102638946,3m_after,0,12,0,12,0,0
102638946,3m_before,0,11,0,11,0,0
102638946,60m_before,0,215,0,215,0,0
102639115,3m_after,0,11,0,11,0,0
102639115,3m_before,0,14,0,14,0,0
102639115,60m_before,0,233,0,233,0,0
102639117,3m_after,0,8,0,8,0,0
102639117,3m_before,1,5,0,6,0,1
102639117,60m_before,5,36,0,41,0,5
102639137,3m_after,0,11,0,11,0,0
102639137,3m_before,0,12,0,12,0,0
102639137,60m_before,0,247,0,247,0,0
102639184,3m_after,0,12,0,12,0,0
102639184,3m_before,0,11,0,11,0,0
102639184,60m_before,0,192,0,192,0,0
102639221,3m_after,0,4,0,4,0,0
102639221,3m_before,0,7,0,7,0,0
102639221,60m_before,0,7,0,7,0,0
102639241,3m_after,0,12,0,12,0,0
102639241,3m_before,0,12,0,12,0,0
102639241,60m_before,0,228,0,228,0,0
102639272,3m_after,3,1,0,4,3,0
102639272,3m_before,2,3,0,5,2,0
102639272,60m_before,8,39,0,47,8,0
102639442,3m_after,0,10,0,10,0,0
102639442,3m_before,0,10,0,10,0,0
102639442,60m_before,0,75,0,75,0,0
102639457,3m_after,0,23,0,23,0,0
102639457,3m_before,0,23,0,23,0,0
102639457,60m_before,2,357,0,359,0,2
102639460,3m_after,0,14,0,14,0,0
102639460,3m_before,0,10,0,10,0,0
102639460,60m_before,0,230,0,230,0,0
102639489,3m_after,0,11,0,11,0,0
102639489,3m_before,0,11,0,11,0,0
102639489,60m_before,0,216,0,216,0,0
102639492,3m_after,0,7,0,7,0,0
102639492,3m_before,0,8,0,8,0,0
102639492,60m_before,4,194,0,198,4,0
102639556,3m_after,0,13,0,13,0,0
102639556,3m_before,0,12,0,12,0,0
102639556,60m_before,0,228,0,228,0,0
102639558,3m_after,0,11,0,11,0,0
102639558,3m_before,0,12,0,12,0,0
102639558,60m_before,1,174,0,175,1,0
102639589,3m_before,0,10,0,10,0,0
102639589,60m_before,1,223,0,224,0,1
102639621,3m_after,0,12,0,12,0,0
102639621,3m_before,0,11,0,11,0,0
102639621,60m_before,0,226,0,226,0,0
102639674,3m_after,0,11,0,11,0,0
102639674,3m_before,0,13,0,13,0,0
102639674,60m_before,0,234,0,234,0,0
102639819,3m_after,0,11,0,11,0,0
102639819,3m_before,0,13,0,13,0,0
102639819,60m_before,0,230,0,230,0,0
102639941,3m_after,0,22,0,22,0,0
102639941,3m_before,0,11,0,11,0,0
102639941,60m_before,0,395,0,395,0,0
102640150,3m_after,0,12,0,12,0,0
102640150,3m_before,0,12,0,12,0,0
102640150,60m_before,0,230,0,230,0,0
102640332,60m_before,0,72,0,72,0,0
102640430,3m_after,0,13,0,13,0,0
102640430,3m_before,0,14,0,14,0,0
102640430,60m_before,0,234,0,234,0,0
102640492,3m_after,0,11,0,11,0,0
102640492,3m_before,0,11,0,11,0,0
102640492,60m_before,0,209,0,209,0,0
102640518,3m_after,0,10,0,10,0,0
102640518,3m_before,0,12,0,12,0,0
102640518,60m_before,0,225,0,225,0,0
102640519,3m_after,0,12,0,12,0,0
102640519,3m_before,0,12,0,12,0,0
102640519,60m_before,0,232,0,232,0,0
102640618,3m_after,0,12,0,12,0,0
102640618,3m_before,0,12,0,12,0,0
102640618,60m_before,0,187,0,187,0,0
102640753,3m_after,0,21,0,21,0,0
102640753,3m_before,0,23,0,23,0,0
102640753,60m_before,0,394,0,394,0,0
102640788,3m_after,0,11,0,11,0,0
102640788,3m_before,0,11,0,11,0,0
102640788,60m_before,0,217,0,217,0,0
102640802,3m_after,0,12,0,12,0,0
102640802,3m_before,0,12,0,12,0,0
102640802,60m_before,0,232,0,232,0,0
102640880,60m_before,0,11,0,11,0,0
102640897,3m_after,0,12,0,12,0,0
102640897,3m_before,0,12,0,12,0,0
102640897,60m_before,0,222,0,222,0,0
102640941,3m_after,0,11,0,11,0,0
102640941,3m_before,0,12,0,12,0,0
102640941,60m_before,0,233,0,233,0,0
102641011,3m_after,0,22,0,22,0,0
102641011,3m_before,0,22,0,22,0,0
102641011,60m_before,12,274,0,286,2,10
102641100,60m_before,0,61,0,61,0,0
102641191,3m_after,0,12,0,12,0,0
102641191,3m_before,0,11,0,11,0,0
102641191,60m_before,0,234,0,234,0,0
102641192,60m_before,0,29,0,29,0,0
102641304,3m_after,0,10,0,10,0,0
102641304,3m_before,0,11,0,11,0,0
102641304,60m_before,4,183,0,187,4,0
102641378,3m_after,0,12,0,12,0,0
102641378,3m_before,0,11,0,11,0,0
102641378,60m_before,0,234,0,234,0,0
102641537,3m_after,0,11,0,11,0,0
102641537,3m_before,0,12,0,12,0,0
102641537,60m_before,0,219,0,219,0,0
102641539,3m_after,0,12,0,12,0,0
102641539,3m_before,0,11,0,11,0,0
102641539,60m_before,0,234,0,234,0,0
102641681,3m_before,0,4,0,4,0,0
102641681,60m_before,0,225,0,225,0,0
102641698,3m_after,0,11,0,11,0,0
102641698,3m_before,0,10,0,10,0,0
102641698,60m_before,1,211,0,212,1,0
102641809,3m_after,0,23,0,23,0,0
102641809,3m_before,0,21,0,21,0,0
102641809,60m_before,0,392,0,392,0,0
102641968,3m_after,0,23,0,23,0,0
102641968,3m_before,0,23,0,23,0,0
102641968,60m_before,2,389,0,391,0,2
102641985,3m_after,0,12,0,12,0,0
102641985,3m_before,0,12,0,12,0,0
102641985,60m_before,0,235,0,235,0,0
102642165,3m_after,0,10,0,10,0,0
102642165,3m_before,0,2,0,2,0,0
102642165,60m_before,0,30,0,30,0,0
102642381,3m_after,0,11,0,11,0,0
102642381,3m_before,0,11,0,11,0,0
102642381,60m_before,0,229,0,229,0,0
102642422,3m_after,0,3,0,3,0,0
102642422,3m_before,0,7,0,7,0,0
102642422,60m_before,0,15,0,15,0,0
102642462,3m_after,0,5,0,5,0,0
102642462,3m_before,0,4,0,4,0,0
102642462,60m_before,0,65,0,65,0,0
102642694,3m_after,0,11,0,11,0,0
102642694,3m_before,0,11,0,11,0,0
102642694,60m_before,0,202,0,202,0,0
102642777,3m_after,0,11,0,11,0,0
102642777,3m_before,0,12,0,12,0,0
102642777,60m_before,1,219,0,220,1,0
102642808,3m_after,0,12,0,12,0,0
102642808,3m_before,0,7,0,7,0,0
102642808,60m_before,0,7,0,7,0,0
102642819,3m_after,0,12,0,12,0,0
102642819,3m_before,0,11,0,11,0,0
102642819,60m_before,0,229,0,229,0,0
102642831,3m_after,0,11,0,11,0,0
102642831,3m_before,0,12,0,12,0,0
102642831,60m_before,0,232,0,232,0,0
102642867,3m_after,0,12,0,12,0,0
102642867,3m_before,0,12,0,12,0,0
102642867,60m_before,0,234,0,234,0,0
102642957,3m_before,0,6,0,6,0,0
102642957,60m_before,0,117,0,117,0,0
102643006,3m_after,0,11,0,11,0,0
102643006,3m_before,0,10,0,10,0,0
102643006,60m_before,2,198,0,200,2,0
102643081,3m_after,0,12,0,12,0,0
102643081,3m_before,0,12,0,12,0,0
102643081,60m_before,0,233,0,233,0,0
102643141,3m_after,1,7,0,8,1,0
102643141,3m_before,2,4,0,6,2,0
102643141,60m_before,16,67,0,83,16,0
102643167,3m_after,1,5,0,6,1,0
102643167,3m_before,0,9,0,9,0,0
102643167,60m_before,2,48,0,50,1,1
102643169,3m_after,0,12,0,12,0,0
102643169,3m_before,0,10,0,10,0,0
102643169,60m_before,0,226,0,226,0,0
102643186,3m_after,0,12,0,12,0,0
102643186,3m_before,0,11,0,11,0,0
102643186,60m_before,0,232,0,232,0,0
102643499,3m_after,0,21,0,21,0,0
102643499,3m_before,0,21,0,21,0,0
102643499,60m_before,0,395,0,395,0,0
102643560,3m_after,0,6,0,6,0,0
102643682,3m_after,0,11,0,11,0,0
102643682,3m_before,0,12,0,12,0,0
102643682,60m_before,0,229,0,229,0,0
102643698,3m_after,0,23,0,23,0,0
102643698,3m_before,0,19,0,19,0,0
102643698,60m_before,0,391,0,391,0,0
102643704,3m_before,0,8,0,8,0,0
102643704,60m_before,0,230,0,230,0,0
102643766,3m_after,0,6,0,6,0,0
102643766,60m_before,0,26,0,26,0,0
102643781,3m_after,0,12,0,12,0,0
102643781,3m_before,0,12,0,12,0,0
102643781,60m_before,0,224,0,224,0,0
102643825,3m_after,0,12,0,12,0,0
102643825,3m_before,0,11,0,11,0,0
102643825,60m_before,0,230,0,230,0,0
102643847,3m_after,0,11,0,11,0,0
102643847,3m_before,0,11,0,11,0,0
102643847,60m_before,0,218,0,218,0,0
102643878,3m_after,1,8,0,9,1,0
102643878,3m_before,0,11,0,11,0,0
102643878,60m_before,1,201,0,202,1,0
102643919,60m_before,0,145,0,145,0,0
102643987,3m_before,0,3,0,3,0,0
102643987,60m_before,0,41,0,41,0,0
102644029,3m_after,0,4,0,4,0,0
102644029,60m_before,0,40,0,40,0,0
102644043,3m_after,0,10,0,10,0,0
102644043,3m_before,0,1,0,1,0,0
102644043,60m_before,0,35,0,35,0,0
102644061,3m_after,0,11,0,11,0,0
102644061,3m_before,0,10,0,10,0,0
102644061,60m_before,1,200,0,201,1,0
102644102,3m_after,0,12,0,12,0,0
102644102,3m_before,0,11,0,11,0,0
102644102,60m_before,0,233,0,233,0,0
102644108,3m_after,0,9,0,9,0,0
102644108,3m_before,0,12,0,12,0,0
102644108,60m_before,1,113,0,114,1,0
102644149,60m_before,0,40,0,40,0,0
102644209,3m_after,0,12,0,12,0,0
102644209,3m_before,0,12,0,12,0,0
102644209,60m_before,0,234,0,234,0,0
102644263,3m_after,0,12,0,12,0,0
102644263,3m_before,0,11,0,11,0,0
102644263,60m_before,0,231,0,231,0,0
102644271,3m_after,1,6,0,7,1,0
102644271,3m_before,0,10,0,10,0,0
102644271,60m_before,17,84,0,101,17,0
102644276,60m_before,0,42,0,42,0,0
102644315,3m_after,0,6,0,6,0,0
102644315,60m_before,0,40,0,40,0,0
102644372,60m_before,0,26,0,26,0,0
102644401,3m_after,0,1,0,1,0,0
102644401,60m_before,0,40,0,40,0,0
102644525,3m_after,0,11,0,11,0,0
102644525,3m_before,0,11,0,11,0,0
102644525,60m_before,0,202,0,202,0,0
102644688,3m_after,0,11,0,11,0,0
102644688,3m_before,0,9,0,9,0,0
102644688,60m_before,1,117,0,118,1,0
102644788,3m_after,0,3,0,3,0,0
102644788,3m_before,0,1,0,1,0,0
102644788,60m_before,0,2,0,2,0,0
102644820,60m_before,0,127,0,127,0,0
102644863,3m_after,0,11,0,11,0,0
102644863,3m_before,0,10,0,10,0,0
102644863,60m_before,0,217,0,217,0,0
102644870,3m_after,0,11,0,11,0,0
102644870,3m_before,0,11,0,11,0,0
102644870,60m_before,0,227,0,227,0,0
102644931,3m_after,0,4,0,4,0,0
102644931,60m_before,0,26,0,26,0,0
102645054,3m_after,0,12,0,12,0,0
102645054,3m_before,0,12,0,12,0,0
102645054,60m_before,0,230,0,230,0,0
102645210,3m_after,0,11,0,11,0,0
102645210,3m_before,0,10,0,10,0,0
102645210,60m_before,2,198,0,200,2,0
102645247,3m_after,0,12,0,12,0,0
102645247,3m_before,0,4,0,4,0,0
102645247,60m_before,0,4,0,4,0,0
102645250,3m_after,0,7,0,7,0,0
102645250,3m_before,0,2,0,2,0,0
102645250,60m_before,0,78,0,78,0,0
102645261,3m_after,0,11,0,11,0,0
102645261,3m_before,0,9,0,9,0,0
102645261,60m_before,0,9,0,9,0,0
102645334,3m_after,0,12,0,12,0,0
102645334,3m_before,0,12,0,12,0,0
102645334,60m_before,0,232,0,232,0,0
102645335,3m_after,0,12,0,12,0,0
102645335,3m_before,0,12,0,12,0,0
102645335,60m_before,0,233,0,233,0,0
102645414,3m_after,0,12,0,12,0,0
102645414,3m_before,0,12,0,12,0,0
102645414,60m_before,0,234,0,234,0,0
102645601,3m_after,0,11,0,11,0,0
102645601,3m_before,0,8,0,8,0,0
102645601,60m_before,0,8,0,8,0,0
102645659,3m_after,0,11,0,11,0,0
102645659,3m_before,0,12,0,12,0,0
102645659,60m_before,0,232,0,232,0,0
102645770,3m_after,1,2,0,3,0,1
102645770,3m_before,0,6,0,6,0,0
102645770,60m_before,3,56,0,59,2,1
102645934,3m_after,0,12,0,12,0,0
102645934,3m_before,0,12,0,12,0,0
102645934,60m_before,0,229,0,229,0,0
102645961,3m_after,0,9,0,9,0,0
102645961,3m_before,0,10,0,10,0,0
102645961,60m_before,2,197,0,199,2,0
102646016,3m_after,0,12,0,12,0,0
102646016,3m_before,0,12,0,12,0,0
102646016,60m_before,0,229,0,229,0,0
102646103,3m_after,0,10,0,10,0,0
102646103,3m_before,0,11,0,11,0,0
102646103,60m_before,1,208,0,209,1,0
102646196,3m_after,0,12,0,12,0,0
102646196,3m_before,0,11,0,11,0,0
102646196,60m_before,0,233,0,233,0,0
102646267,3m_after,0,12,0,12,0,0
102646267,3m_before,0,12,0,12,0,0
102646267,60m_before,0,229,0,229,0,0
102646316,3m_after,0,12,0,12,0,0
102646316,3m_before,0,12,0,12,0,0
102646316,60m_before,0,231,0,231,0,0
102646342,3m_after,0,8,0,8,0,0
102646342,3m_before,0,4,0,4,0,0
102646342,60m_before,0,49,0,49,0,0
102646527,3m_after,0,11,0,11,0,0
102646527,3m_before,0,12,0,12,0,0
102646527,60m_before,0,233,0,233,0,0
102646656,3m_after,0,1,0,1,0,0
102646656,3m_before,0,7,0,7,0,0
102646656,60m_before,0,44,0,44,0,0
102646722,3m_after,0,12,0,12,0,0
102646722,3m_before,0,11,0,11,0,0
102646722,60m_before,0,228,0,228,0,0
102646737,3m_after,0,1,0,1,0,0
102646737,60m_before,0,89,0,89,0,0
102646839,3m_after,0,12,0,12,0,0
102646839,3m_before,0,12,0,12,0,0
102646839,60m_before,0,229,0,229,0,0
102646850,3m_after,0,12,0,12,0,0
102646850,3m_before,0,11,0,11,0,0
102646850,60m_before,0,230,0,230,0,0
102646945,3m_after,0,12,0,12,0,0
102646945,3m_before,0,12,0,12,0,0
102646945,60m_before,0,220,0,220,0,0
102646949,3m_after,0,2,0,2,0,0
102646949,3m_before,0,11,0,11,0,0
102646949,60m_before,0,35,0,35,0,0
102646996,3m_after,0,12,0,12,0,0
102646996,3m_before,0,8,0,8,0,0
102646996,60m_before,0,183,0,183,0,0
102647028,3m_after,0,1,0,1,0,0
102647028,3m_before,0,11,0,11,0,0
102647028,60m_before,0,36,0,36,0,0
102647214,3m_after,0,12,0,12,0,0
102647214,3m_before,0,12,0,12,0,0
102647214,60m_before,0,233,0,233,0,0
102647264,3m_after,0,12,0,12,0,0
102647264,3m_before,0,12,0,12,0,0
102647264,60m_before,0,232,0,232,0,0
102647322,3m_after,0,12,0,12,0,0
102647322,3m_before,0,12,0,12,0,0
102647322,60m_before,0,232,0,232,0,0
102647376,3m_after,0,12,0,12,0,0
102647376,3m_before,0,11,0,11,0,0
102647376,60m_before,0,230,0,230,0,0
102647386,3m_after,0,11,0,11,0,0
102647386,3m_before,0,12,0,12,0,0
102647386,60m_before,0,231,0,231,0,0
102647595,3m_after,0,12,0,12,0,0
102647595,3m_before,0,12,0,12,0,0
102647595,60m_before,0,231,0,231,0,0
102647618,3m_after,0,12,0,12,0,0
102647618,3m_before,0,11,0,11,0,0
102647618,60m_before,0,234,0,234,0,0
102647703,3m_after,0,19,0,19,0,0
102647703,3m_before,0,12,0,12,0,0
102647703,60m_before,3,200,0,203,0,3
102647707,3m_after,0,11,0,11,0,0
102647707,3m_before,0,12,0,12,0,0
102647707,60m_before,0,235,0,235,0,0
102647766,3m_after,0,17,0,17,0,0
102647766,3m_before,0,12,0,12,0,0
102647766,60m_before,3,189,0,192,3,0
102647890,3m_after,0,11,0,11,0,0
102647890,3m_before,0,12,0,12,0,0
102647890,60m_before,0,224,0,224,0,0
102647933,3m_after,1,4,0,5,1,0
102647933,3m_before,0,10,0,10,0,0
102647933,60m_before,23,113,0,136,23,0
102648039,3m_after,0,11,0,11,0,0
102648039,3m_before,0,11,0,11,0,0
102648039,60m_before,0,217,0,217,0,0
102648083,3m_after,0,12,0,12,0,0
102648083,3m_before,0,12,0,12,0,0
102648083,60m_before,1,196,0,197,1,0
102648123,3m_after,0,11,0,11,0,0
102648123,3m_before,0,11,0,11,0,0
102648123,60m_before,0,209,0,209,0,0
102648191,3m_after,1,0,0,1,1,0
102648191,60m_before,0,155,0,155,0,0
102648284,3m_after,0,11,0,11,0,0
102648284,3m_before,0,12,0,12,0,0
102648284,60m_before,0,12,0,12,0,0
102648305,3m_after,0,12,0,12,0,0
102648305,3m_before,0,11,0,11,0,0
102648305,60m_before,0,221,0,221,0,0
102648342,3m_after,0,11,0,11,0,0
102648342,3m_before,0,11,0,11,0,0
102648342,60m_before,0,224,0,224,0,0
102648421,3m_after,0,1,0,1,0,0
102648421,3m_before,0,12,0,12,0,0
102648421,60m_before,0,233,0,233,0,0
102648433,3m_after,0,22,0,22,0,0
102648433,3m_before,0,22,0,22,0,0
102648433,60m_before,0,454,0,454,0,0
102648469,3m_after,0,11,0,11,0,0
102648469,3m_before,0,11,0,11,0,0
102648469,60m_before,0,218,0,218,0,0
102648517,3m_after,0,9,0,9,0,0
102648517,3m_before,1,5,0,6,1,0
102648517,60m_before,23,113,0,136,23,0
102648726,3m_after,0,11,0,11,0,0
102648726,3m_before,0,12,0,12,0,0
102648726,60m_before,0,233,0,233,0,0
102648772,60m_before,0,37,0,37,0,0
102648787,3m_after,0,12,0,12,0,0
102648787,3m_before,0,11,0,11,0,0
102648787,60m_before,0,230,0,230,0,0
102648796,3m_after,1,6,0,7,1,0
102648796,3m_before,0,8,0,8,0,0
102648796,60m_before,21,118,0,139,21,0
102648814,3m_after,0,11,0,11,0,0
102648814,3m_before,0,12,0,12,0,0
102648814,60m_before,0,221,0,221,0,0
102648855,3m_after,0,10,0,10,0,0
102648855,3m_before,0,11,0,11,0,0
102648855,60m_before,1,200,0,201,1,0
102648893,60m_before,1,30,0,31,0,1
102648928,3m_before,1,0,0,1,0,1
102648928,60m_before,1,30,0,31,0,1
102648964,3m_after,0,1,0,1,0,0
102648964,3m_before,0,5,0,5,0,0
102648964,60m_before,0,83,0,83,0,0
102648989,60m_before,0,40,0,40,0,0
102648996,3m_after,0,11,0,11,0,0
102648996,3m_before,0,12,0,12,0,0
102648996,60m_before,0,232,0,232,0,0
102649000,3m_after,0,4,0,4,0,0
102649000,60m_before,0,34,0,34,0,0
102649166,60m_before,0,37,0,37,0,0
102649280,3m_before,0,4,0,4,0,0
102649280,60m_before,0,139,0,139,0,0
102649300,3m_after,0,11,0,11,0,0
102649300,3m_before,0,12,0,12,0,0
102649300,60m_before,1,222,0,223,1,0
102649303,3m_after,0,11,0,11,0,0
102649303,3m_before,0,12,0,12,0,0
102649303,60m_before,0,231,0,231,0,0
102649358,3m_after,0,12,0,12,0,0
102649358,3m_before,0,1,0,1,0,0
102649358,60m_before,0,41,0,41,0,0
102649369,3m_after,0,11,0,11,0,0
102649369,3m_before,0,12,0,12,0,0
102649369,60m_before,0,225,0,225,0,0
102649396,3m_after,0,11,0,11,0,0
102649396,3m_before,0,11,0,11,0,0
102649396,60m_before,0,213,0,213,0,0
102649400,3m_after,0,12,0,12,0,0
102649400,3m_before,0,12,0,12,0,0
102649400,60m_before,0,232,0,232,0,0
102649448,3m_after,0,11,0,11,0,0
102649448,3m_before,0,12,0,12,0,0
102649448,60m_before,0,228,0,228,0,0
102649453,3m_after,0,11,0,11,0,0
102649453,3m_before,0,11,0,11,0,0
102649453,60m_before,0,234,0,234,0,0
102649470,60m_before,0,37,0,37,0,0
102649484,3m_after,0,12,0,12,0,0
102649484,3m_before,0,11,0,11,0,0
102649484,60m_before,0,234,0,234,0,0
102649496,3m_after,0,12,0,12,0,0
102649496,3m_before,0,11,0,11,0,0
102649496,60m_before,0,231,0,231,0,0
102649533,3m_before,0,1,0,1,0,0
102649533,60m_before,0,19,0,19,0,0
102649561,3m_after,0,1,0,1,0,0
102649561,3m_before,0,2,0,2,0,0
102649561,60m_before,0,110,0,110,0,0
102649573,3m_after,0,6,0,6,0,0
102649573,60m_before,0,41,0,41,0,0
102649739,3m_after,0,11,0,11,0,0
102649739,3m_before,0,2,0,2,0,0
102649739,60m_before,0,42,0,42,0,0
102649797,3m_after,0,11,0,11,0,0
102649797,3m_before,0,2,0,2,0,0
102649797,60m_before,0,42,0,42,0,0
102649970,3m_after,0,20,0,20,0,0
102649970,3m_before,0,22,0,22,0,0
102649970,60m_before,2,257,0,259,0,2
102650016,3m_after,0,11,0,11,0,0
102650016,3m_before,0,12,0,12,0,0
102650016,60m_before,0,224,0,224,0,0
102650089,3m_after,0,11,0,11,0,0
102650089,3m_before,0,12,0,12,0,0
102650089,60m_before,0,232,0,232,0,0
102650098,3m_after,0,11,0,11,0,0
102650098,3m_before,0,11,0,11,0,0
102650098,60m_before,0,231,0,231,0,0
102650131,3m_after,0,12,0,12,0,0
102650131,3m_before,0,12,0,12,0,0
102650131,60m_before,0,134,0,134,0,0
102650147,3m_after,0,11,0,11,0,0
102650147,3m_before,0,11,0,11,0,0
102650147,60m_before,0,214,0,214,0,0
102650281,3m_after,0,4,0,4,0,0
102650281,3m_before,0,14,0,14,0,0
102650281,60m_before,0,425,0,425,0,0
102650300,60m_before,20,105,0,125,20,0
102650445,60m_before,0,111,0,111,0,0
102650468,3m_after,0,11,0,11,0,0
102650468,3m_before,0,12,0,12,0,0
102650468,60m_before,0,108,0,108,0,0
102650480,3m_after,0,11,0,11,0,0
102650480,3m_before,0,12,0,12,0,0
102650480,60m_before,0,233,0,233,0,0
102650528,3m_after,0,12,0,12,0,0
102650528,3m_before,0,12,0,12,0,0
102650528,60m_before,0,231,0,231,0,0
102650543,3m_after,0,12,0,12,0,0
102650543,3m_before,0,11,0,11,0,0
102650543,60m_before,0,231,0,231,0,0
102650578,60m_before,0,56,0,56,0,0
102650604,3m_after,0,12,0,12,0,0
102650604,3m_before,0,11,0,11,0,0
102650604,60m_before,1,189,0,190,1,0
102650627,3m_after,0,11,0,11,0,0
102650627,3m_before,0,10,0,10,0,0
102650627,60m_before,1,203,0,204,1,0
102650642,3m_after,0,11,0,11,0,0
102650642,3m_before,0,11,0,11,0,0
102650642,60m_before,1,222,0,223,1,0
102650649,3m_after,0,6,0,6,0,0
102650649,3m_before,0,9,0,9,0,0
102650649,60m_before,0,423,0,423,0,0
102650726,3m_after,0,11,0,11,0,0
102650726,3m_before,0,11,0,11,0,0
102650726,60m_before,0,230,0,230,0,0
102650776,3m_after,0,21,0,21,0,0
102650776,3m_before,0,12,0,12,0,0
102650776,60m_before,0,233,0,233,0,0
102650818,3m_after,0,5,0,5,0,0
102650818,3m_before,0,9,0,9,0,0
102650818,60m_before,0,60,0,60,0,0
102650846,3m_after,0,11,0,11,0,0
102650846,3m_before,0,12,0,12,0,0
102650846,60m_before,0,232,0,232,0,0
102650885,3m_after,1,18,0,19,1,0
102650885,3m_before,0,22,0,22,0,0
102650885,60m_before,2,275,0,277,0,2
102650921,3m_after,0,12,0,12,0,0
102650921,3m_before,0,12,0,12,0,0
102650921,60m_before,0,232,0,232,0,0
102651037,3m_after,0,12,0,12,0,0
102651037,3m_before,0,12,0,12,0,0
102651037,60m_before,0,229,0,229,0,0
102651065,3m_after,0,23,0,23,0,0
102651065,3m_before,0,16,0,16,0,0
102651065,60m_before,0,238,0,238,0,0
102651070,3m_after,0,11,0,11,0,0
102651070,3m_before,0,11,0,11,0,0
102651070,60m_before,0,215,0,215,0,0
102651081,3m_after,0,11,0,11,0,0
102651081,3m_before,0,9,0,9,0,0
102651081,60m_before,0,417,0,417,0,0
102651176,3m_after,0,12,0,12,0,0
102651176,3m_before,0,11,0,11,0,0
102651176,60m_before,0,228,0,228,0,0
102651201,3m_after,0,9,0,9,0,0
102651201,3m_before,0,11,0,11,0,0
102651201,60m_before,1,202,0,203,1,0
102651214,3m_after,0,12,0,12,0,0
102651214,3m_before,0,10,0,10,0,0
102651214,60m_before,0,229,0,229,0,0
102651293,3m_after,0,10,0,10,0,0
102651293,3m_before,0,10,0,10,0,0
102651293,60m_before,0,230,0,230,0,0
102651299,3m_after,0,12,0,12,0,0
102651299,3m_before,0,7,0,7,0,0
102651299,60m_before,0,67,0,67,0,0
102651337,3m_after,1,5,0,6,1,0
102651337,3m_before,0,12,0,12,0,0
102651337,60m_before,1,225,0,226,1,0
102651346,3m_after,0,12,0,12,0,0
102651346,3m_before,0,11,0,11,0,0
102651346,60m_before,0,230,0,230,0,0
102651386,3m_after,1,0,0,1,1,0
102651386,3m_before,0,3,0,3,0,0
102651386,60m_before,0,78,0,78,0,0
102651561,60m_before,0,37,0,37,0,0
102651766,3m_after,0,11,0,11,0,0
102651766,3m_before,0,11,0,11,0,0
102651766,60m_before,0,396,0,396,0,0
102651798,60m_before,0,114,0,114,0,0
102651810,60m_before,0,37,0,37,0,0
102651818,3m_after,0,23,0,23,0,0
102651818,3m_before,0,24,0,24,0,0
102651818,60m_before,0,265,0,265,0,0
102651853,60m_before,2,109,0,111,2,0
102651864,60m_before,0,37,0,37,0,0
102651917,3m_after,0,11,0,11,0,0
102651917,3m_before,0,9,0,9,0,0
102651917,60m_before,1,203,0,204,1,0
102651947,3m_after,0,12,0,12,0,0
102651947,3m_before,0,11,0,11,0,0
102651947,60m_before,0,228,0,228,0,0
102651965,3m_after,0,11,0,11,0,0
102651965,3m_before,0,12,0,12,0,0
102651965,60m_before,1,191,0,192,1,0
102652038,60m_before,0,37,0,37,0,0
102652046,3m_after,0,10,0,10,0,0
102652046,3m_before,0,2,0,2,0,0
102652046,60m_before,1,79,0,80,1,0
102652137,3m_after,0,11,0,11,0,0
102652137,3m_before,0,12,0,12,0,0
102652137,60m_before,0,135,0,135,0,0
102652166,3m_after,0,12,0,12,0,0
102652166,3m_before,0,23,0,23,0,0
102652166,60m_before,0,279,0,279,0,0
102652233,60m_before,0,79,0,79,0,0
102652270,60m_before,0,37,0,37,0,0
102652316,3m_after,0,11,0,11,0,0
102652316,3m_before,0,13,0,13,0,0
102652316,60m_before,0,228,0,228,0,0
102652369,3m_after,0,15,0,15,0,0
102652369,3m_before,0,23,0,23,0,0
102652369,60m_before,0,276,0,276,0,0
102652407,3m_after,0,11,0,11,0,0
102652407,3m_before,0,12,0,12,0,0
102652407,60m_before,0,229,0,229,0,0
102652414,3m_after,0,11,0,11,0,0
102652414,3m_before,0,3,0,3,0,0
102652414,60m_before,1,146,0,147,1,0
102652431,3m_after,1,1,0,2,1,0
102652431,3m_before,1,4,0,5,1,0
102652431,60m_before,14,88,0,102,14,0
102652449,3m_after,1,1,0,2,1,0
102652449,3m_before,1,4,0,5,1,0
102652449,60m_before,14,88,0,102,14,0
102652456,60m_before,0,37,0,37,0,0
102652522,60m_before,0,37,0,37,0,0
102652553,3m_after,0,11,0,11,0,0
102652553,3m_before,0,12,0,12,0,0
102652553,60m_before,0,227,0,227,0,0
102652681,3m_after,0,11,0,11,0,0
102652681,3m_before,0,11,0,11,0,0
102652681,60m_before,0,218,0,218,0,0
102652720,3m_after,0,12,0,12,0,0
102652720,3m_before,0,13,0,13,0,0
102652720,60m_before,0,279,0,279,0,0
102652742,60m_before,0,37,0,37,0,0
102652775,3m_after,0,12,0,12,0,0
102652775,3m_before,0,11,0,11,0,0
102652775,60m_before,0,231,0,231,0,0
102652939,3m_after,0,10,0,10,0,0
102652939,3m_before,0,11,0,11,0,0
102652939,60m_before,0,215,0,215,0,0
102652996,3m_after,0,3,0,3,0,0
102652996,3m_before,1,5,0,6,1,0
102652996,60m_before,2,7,0,9,2,0
102653002,60m_before,0,37,0,37,0,0
102653010,3m_after,1,2,0,3,1,0
102653010,3m_before,0,7,0,7,0,0
102653010,60m_before,13,83,0,96,13,0
102653151,3m_after,0,11,0,11,0,0
102653151,3m_before,0,11,0,11,0,0
102653151,60m_before,1,224,0,225,1,0
102653303,3m_after,0,11,0,11,0,0
102653303,3m_before,0,12,0,12,0,0
102653303,60m_before,0,232,0,232,0,0
102653390,3m_after,0,11,0,11,0,0
102653390,3m_before,0,12,0,12,0,0
102653390,60m_before,0,232,0,232,0,0
102653462,60m_before,0,37,0,37,0,0
102653472,3m_after,0,11,0,11,0,0
102653472,3m_before,0,12,0,12,0,0
102653472,60m_before,0,230,0,230,0,0
102653493,3m_after,0,12,0,12,0,0
102653493,3m_before,0,12,0,12,0,0
102653493,60m_before,0,357,0,357,0,0
102653523,3m_after,0,11,0,11,0,0
102653523,3m_before,0,11,0,11,0,0
102653523,60m_before,0,216,0,216,0,0
102653561,3m_after,0,6,0,6,0,0
102653561,60m_before,0,16,0,16,0,0
102653726,3m_after,0,3,0,3,0,0
102653726,3m_before,0,1,0,1,0,0
102653726,60m_before,0,148,0,148,0,0
102653823,3m_after,0,11,0,11,0,0
102653823,3m_before,0,12,0,12,0,0
102653823,60m_before,2,214,0,216,2,0
102653853,3m_after,0,10,0,10,0,0
102653853,3m_before,0,12,0,12,0,0
102653853,60m_before,0,233,0,233,0,0
102653875,3m_after,0,11,0,11,0,0
102653875,3m_before,0,11,0,11,0,0
102653875,60m_before,0,232,0,232,0,0
102653961,3m_after,0,12,0,12,0,0
102653961,3m_before,0,11,0,11,0,0
102653961,60m_before,0,178,0,178,0,0
102654010,3m_after,0,11,0,11,0,0
102654010,3m_before,0,11,0,11,0,0
102654010,60m_before,0,217,0,217,0,0
102654027,60m_before,0,37,0,37,0,0
102654031,3m_before,0,5,0,5,0,0
102654031,60m_before,0,19,0,19,0,0
102654080,3m_after,0,11,0,11,0,0
102654080,3m_before,0,11,0,11,0,0
102654080,60m_before,1,224,0,225,1,0
102654092,60m_before,0,37,0,37,0,0
102654097,3m_after,0,12,0,12,0,0
102654097,3m_before,0,10,0,10,0,0
102654097,60m_before,0,231,0,231,0,0
102654152,60m_before,0,9,0,9,0,0
102654159,3m_after,0,11,0,11,0,0
102654159,3m_before,0,11,0,11,0,0
102654159,60m_before,0,164,0,164,0,0
102654270,3m_after,0,7,0,7,0,0
102654285,3m_after,0,12,0,12,0,0
102654285,3m_before,0,11,0,11,0,0
102654285,60m_before,1,224,0,225,1,0
102654314,3m_after,0,7,0,7,0,0
102654314,60m_before,11,61,0,72,11,0
102654413,3m_before,0,5,0,5,0,0
102654413,60m_before,0,84,0,84,0,0
102654420,3m_after,0,12,0,12,0,0
102654420,3m_before,0,12,0,12,0,0
102654420,60m_before,0,233,0,233,0,0
102654442,3m_after,0,10,0,10,0,0
102654442,3m_before,0,12,0,12,0,0
102654442,60m_before,0,231,0,231,0,0
102654457,3m_after,0,11,0,11,0,0
102654457,3m_before,0,11,0,11,0,0
102654457,60m_before,0,216,0,216,0,0
102654462,3m_before,0,7,0,7,0,0
102654462,60m_before,0,274,0,274,0,0
102654536,3m_after,0,12,0,12,0,0
102654536,3m_before,0,11,0,11,0,0
102654536,60m_before,0,227,0,227,0,0
102654573,3m_after,0,22,0,22,0,0
102654573,3m_before,0,22,0,22,0,0
102654573,60m_before,0,168,0,168,0,0
102654618,3m_after,0,11,0,11,0,0
102654618,3m_before,0,11,0,11,0,0
102654618,60m_before,0,219,0,219,0,0
102654665,3m_after,0,11,0,11,0,0
102654665,3m_before,0,11,0,11,0,0
102654665,60m_before,0,231,0,231,0,0
102654795,3m_after,0,6,0,6,0,0
102654795,3m_before,1,0,0,1,1,0
102654795,60m_before,2,72,0,74,2,0
102654826,60m_before,0,3,0,3,0,0
102654833,3m_after,0,12,0,12,0,0
102654833,3m_before,0,11,0,11,0,0
102654833,60m_before,0,227,0,227,0,0
102654867,3m_before,0,6,0,6,0,0
102654867,60m_before,0,248,0,248,0,0
102654923,3m_after,0,11,0,11,0,0
102654923,3m_before,0,12,0,12,0,0
102654923,60m_before,0,231,0,231,0,0
102654971,3m_after,0,12,0,12,0,0
102654971,3m_before,0,11,0,11,0,0
102654971,60m_before,0,230,0,230,0,0
102654976,3m_after,0,11,0,11,0,0
102654976,3m_before,0,11,0,11,0,0
102654976,60m_before,0,219,0,219,0,0
102655118,3m_after,0,8,0,8,0,0
102655118,3m_before,1,7,0,8,1,0
102655118,60m_before,4,189,0,193,4,0
102655255,3m_after,0,20,0,20,0,0
102655255,3m_before,0,24,0,24,0,0
102655255,60m_before,5,352,0,357,3,2
102655312,3m_after,0,22,0,22,0,0
102655312,3m_before,0,20,0,20,0,0
102655312,60m_before,5,360,0,365,3,2
102655318,3m_after,0,11,0,11,0,0
102655318,3m_before,0,12,0,12,0,0
102655318,60m_before,0,231,0,231,0,0
102655333,60m_before,0,4,0,4,0,0
102655516,60m_before,0,4,0,4,0,0
102655595,3m_after,0,12,0,12,0,0
102655595,3m_before,0,12,0,12,0,0
102655595,60m_before,0,227,0,227,0,0
102655748,3m_before,0,6,0,6,0,0
102655748,60m_before,0,245,0,245,0,0
102655966,3m_after,1,9,0,10,1,0
102655966,3m_before,1,7,0,8,1,0
102655966,60m_before,5,184,0,189,5,0
102656041,3m_after,0,11,0,11,0,0
102656041,3m_before,0,10,0,10,0,0
102656041,60m_before,0,212,0,212,0,0
102656052,3m_after,0,12,0,12,0,0
102656052,3m_before,0,11,0,11,0,0
102656052,60m_before,0,230,0,230,0,0
102656062,3m_after,1,6,0,7,1,0
102656062,3m_before,0,7,0,7,0,0
102656062,60m_before,0,51,0,51,0,0
102656174,3m_before,1,0,0,1,1,0
102656174,60m_before,5,89,0,94,3,2
102656310,3m_after,2,4,0,6,2,0
102656310,3m_before,0,11,0,11,0,0
102656310,60m_before,5,185,0,190,5,0
102656316,3m_after,0,12,0,12,0,0
102656316,3m_before,0,12,0,12,0,0
102656316,60m_before,0,231,0,231,0,0
102656318,3m_after,0,12,0,12,0,0
102656318,3m_before,0,12,0,12,0,0
102656318,60m_before,0,230,0,230,0,0
102656417,3m_after,0,12,0,12,0,0
102656417,3m_before,0,12,0,12,0,0
102656417,60m_before,0,227,0,227,0,0
102656494,3m_after,0,11,0,11,0,0
102656494,3m_before,0,11,0,11,0,0
102656494,60m_before,0,219,0,219,0,0
102656602,3m_after,0,12,0,12,0,0
102656602,3m_before,0,11,0,11,0,0
102656602,60m_before,0,233,0,233,0,0
102656651,3m_after,0,12,0,12,0,0
102656651,3m_before,0,11,0,11,0,0
102656651,60m_before,0,233,0,233,0,0
102656760,3m_after,0,11,0,11,0,0
102656760,3m_before,0,3,0,3,0,0
102656760,60m_before,5,84,0,89,3,2
102656881,3m_after,0,12,0,12,0,0
102656881,3m_before,0,12,0,12,0,0
102656881,60m_before,0,231,0,231,0,0
102657111,3m_after,0,12,0,12,0,0
102657111,3m_before,0,11,0,11,0,0
102657111,60m_before,0,234,0,234,0,0
102657154,3m_after,0,12,0,12,0,0
102657154,3m_before,0,12,0,12,0,0
102657154,60m_before,0,228,0,228,0,0
102657319,3m_after,0,12,0,12,0,0
102657319,3m_before,0,10,0,10,0,0
102657319,60m_before,0,218,0,218,0,0
102657358,3m_after,0,11,0,11,0,0
102657358,3m_before,0,12,0,12,0,0
102657358,60m_before,0,228,0,228,0,0
102657566,3m_after,0,11,0,11,0,0
102657566,3m_before,0,12,0,12,0,0
102657566,60m_before,0,234,0,234,0,0
102657601,3m_after,0,12,0,12,0,0
102657601,3m_before,0,11,0,11,0,0
102657601,60m_before,0,230,0,230,0,0
102658051,60m_before,0,182,0,182,0,0
102658115,3m_after,0,11,0,11,0,0
102658115,3m_before,0,10,0,10,0,0
102658115,60m_before,0,222,0,222,0,0
102658395,3m_after,0,11,0,11,0,0
102658395,3m_before,0,12,0,12,0,0
102658395,60m_before,0,230,0,230,0,0
102658433,60m_before,1,67,0,68,1,0
102658765,3m_after,0,6,0,6,0,0
102658765,60m_before,1,67,0,68,1,0
102658910,3m_after,0,1,0,1,0,0
102658910,60m_before,0,150,0,150,0,0
102659311,3m_after,0,11,0,11,0,0
102659311,3m_before,0,12,0,12,0,0
102659311,60m_before,0,201,0,201,0,0
102659387,3m_after,1,3,0,4,1,0
102659387,60m_before,8,20,0,28,8,0
102659420,3m_after,0,12,0,12,0,0
102659420,3m_before,0,12,0,12,0,0
102659420,60m_before,0,231,0,231,0,0
102660155,3m_after,0,11,0,11,0,0
102660155,3m_before,0,12,0,12,0,0
102660155,60m_before,0,225,0,225,0,0
102660317,3m_after,0,12,0,12,0,0
102660585,3m_after,0,11,0,11,0,0
102660585,3m_before,0,12,0,12,0,0
102660585,60m_before,0,230,0,230,0,0
102660613,3m_after,0,11,0,11,0,0
102660613,3m_before,0,3,0,3,0,0
102660613,60m_before,5,75,0,80,3,2
102660647,3m_after,0,11,0,11,0,0
102660647,3m_before,0,1,0,1,0,0
102660647,60m_before,0,72,0,72,0,0
102660717,3m_after,0,8,0,8,0,0
102660717,3m_before,0,11,0,11,0,0
102660717,60m_before,1,98,0,99,1,0
102660766,3m_after,0,11,0,11,0,0
102660766,3m_before,0,8,0,8,0,0
102660766,60m_before,5,77,0,82,3,2
102661217,60m_before,0,71,0,71,0,0
102661295,3m_after,0,11,0,11,0,0
102661295,3m_before,0,12,0,12,0,0
102661295,60m_before,0,233,0,233,0,0
102661356,3m_after,0,12,0,12,0,0
102661356,3m_before,0,12,0,12,0,0
102661356,60m_before,0,229,0,229,0,0
102661915,3m_after,0,12,0,12,0,0
102661915,3m_before,0,11,0,11,0,0
102661915,60m_before,1,221,0,222,0,1
102662459,3m_after,0,23,0,23,0,0
102662459,3m_before,0,24,0,24,0,0
102662459,60m_before,0,461,0,461,0,0
102662922,3m_after,0,10,0,10,0,0
102662922,3m_before,0,11,0,11,0,0
102662922,60m_before,3,84,0,87,3,0
102663203,60m_before,0,4,0,4,0,0
102663748,60m_before,0,2,0,2,0,0
102664036,3m_after,0,24,0,24,0,0
102664036,3m_before,0,24,0,24,0,0
102664036,60m_before,0,461,0,461,0,0
102664046,3m_after,0,10,0,10,0,0
102664046,3m_before,0,10,0,10,0,0
102664046,60m_before,2,108,0,110,2,0
102664423,60m_before,0,2,0,2,0,0
102664444,60m_before,0,2,0,2,0,0
102665113,3m_after,0,10,0,10,0,0
102665113,3m_before,0,10,0,10,0,0
102665113,60m_before,2,111,0,113,1,1
